关键词,整体指数,PC指数,移动指数,排名,收录量,网址
起名,14677,1559,13118,1,47200000,www.yw11.com
起名网,11442,1198,10244,1,9610000,www.yw11.com
取名字,8102,860,7242,1,20300000,http://www.baidu.com/link?url=VQM405zGTTbO8mLrBOLPiVFjBvtzC6rOY2tQbH5hdWLDHuFZfQ04bh2ZP99pxK_C
公司起名,7027,1051,5976,1,16800000,http://www.baidu.com/link?url=TYlqJnZC7BRnxx50IuUMHNYFNSPm0JiXDYQt3lMGbkQm63P__87oRX1ft5Fzqm6L
微信名字,6527,480,6047,1,11500000,http://www.baidu.com/link?url=icl1s3ugkxd66IVTbjGq5HcVh8OdNZRCOm1Q4DHUNkEpFAH305XypKpm-0JPwUBrvxmHC6mdXyiFFal609YIKK
宝宝起名,6083,593,5490,1,14500000,www.yw11.com
好听的名字,5605,811,4794,1,30700000,http://www.baidu.com/link?url=t6s_ezMl2ghKmEkcXk_rtneKvzIsCHIQEKApLMymCUoRLHHkckSMIsTIzCqjy26SGwTTRee1JNNAbHkMKb2QgUt-PCGfl5fk4C3ZHltx1py
女孩名字,5469,728,4741,1,44200000,http://www.baidu.com/link?url=t5djMU_BsRkl0NmfJmSH8jvqjwnfDxkYTcnyCXtkFl3pY7OPQ3D0lk3ksUSESILtBgnXX9WHgMvDAu3HJWELW265H5ec8RfHdV30ngic81W
取名,5043,1453,3590,1,31500000,www.yw11.com
起名字,4705,509,4196,1,30700000,www.yw11.com
起名大全,4654,341,4313,1,15800000,www.yw11.com
取名网,3968,609,3359,1,11300000,www.yw11.com
群名称大全,3857,222,3635,1,1060000,http://www.baidu.com/link?url=XtWeUUeeP8HsHxNS3t8a3lTlMN6afOrDORc_k9WOCyfHNW2EPCwaVUpxK4y8rnMFGGuB2KqEvYjNyu9vv7HLYzVaaYO8wh2Y_-D9-z9a4mG
英文名字,3706,845,2861,1,43700000,http://www.baidu.com/link?url=2Se_a-RB2plGShz5DIdL9tmrKQz907316iNWEIJYlP55DyAHoTjUjZhuNXR7HOwya5O51Q5QPqyOev6vKCj3hLXNrOaDRj2hUanfikvXp8i
取名打分,3654,106,3548,1,9460000,www.yw11.com
小名,3329,301,3028,1,16300000,http://www.baidu.com/link?url=psLxSHZcNpar7XWsf4Cu80E5So3PokBKpp9RV-nynLdEVvbl57Taz_xeHsUzQ2Wx
男孩名字,3270,400,2870,1,37500000,http://www.baidu.com/link?url=XvPZaC6FaD9feKn0AhXjW-Binip6EFy3llLnM2gNQLjFZNrWV8vf99zRUDQVd-yStOYT3jKMg1-WyJ5tDBleDY1yLpfY54zdy92bty3YxrG
周易取名,3266,674,2592,1,6540000,http://www.baidu.com/link?url=qYx3BF8aNvOmplB_vbjDzywb7q7kwSDvghgQKz15H_9X44LYNuAfJ-cfH0c9f47E09wATfnJKgQwuTlAm30JHa
生辰八字起名,3265,388,2877,1,12200000,www.yw11.com
诗经取名,2916,585,2331,1,4670000,http://www.baidu.com/link?url=I5l1GQf_ZeU2klxzRLKyo6lsO_EO-NENGUqox_DVUv5RDVuiMpDF8AO217OjV4AyCfCkxNsUUrV0sUxAu9-2JzgM9nsmpiuBlAMD8w7ESvy
取名宝典,2826,280,2546,1,492000,http://www.baidu.com/link?url=EEZDh3g78rLVsMY6U1MqYZWvay2bKsw9M6vltJlk3HJfHLRVcaiepyf8zWZXPd-gxZ36o0grR-UGzG1OTfR7w_
给宝宝起个好名字,2680,162,2518,1,32700000,http://www.baidu.com/link?url=eQRDzSEhb80kUpBbk6AH6NqT78hXpf_WSA0_Fj7DbB0uteEoU4xqWpOtNo6JvdTa
乳名,2609,236,2373,1,8530000,http://www.baidu.com/link?url=SGcp1_Z473iqR-YYO62yWOU_LYMs1cVGVNdDxwjYAQGNUezqUm_Tgn24j2sRi8Bt
微信名字大全男,2450,279,2171,1,12000000,http://www.baidu.com/link?url=QJhkl7s9hiVXIw62AFesqMssg9HdmFNEvM_EpuXkp6hFiSGkbv3rSGX9mCW5O2u6NjcS-RGvy-BWZ6Lgy1f-eGpUIuOriqEYp-6FnomBiz-0UuqLDVvBpf6-WJfGcug9
女孩取名,2423,144,2279,1,19000000,http://www.baidu.com/link?url=YW1f0XP1VRcOq8YtwsIv-ezUGGfzgYeEWjRXQchST9w_NkI8aggO8GnSoYCqhL-Ge-OibvAqJUPpmGU2UFi0tgSGrnLO2KvZXEha8ME8fpW
男宝宝名字,2421,86,2335,1,21900000,http://www.baidu.com/link?url=WpqJoMSB3T1SkMod_8uTKbOH-v0olRU425FilNT7qwAr-V7dFHYOjUk93VskH2Sd6dO4vi7b7UcWJSh50Ucz_E_wSvgMCUe2dxjXl13w2QG
好听的女孩名字,2417,279,2138,1,12800000,http://www.baidu.com/link?url=4AthDsFeIM5BmhH0Sd4B8r26hO8qgWc2sgMJyeqhd1X8laS97EBwFK05PK9hI2Dg-x-RZc5Ce4pqI0mE-Zyc_DkSMsX3sD7heFhM_SqrYpS
男孩子取名,2190,92,2098,1,9000000,http://www.baidu.com/link?url=rOcOZlPwH-titPS3tckQkWjP4Xkakn9Yld0LEeinFmTZ500_RQKSHuwQxIqOqSAaqUrmWGYD30r1l9T6-XrLBAZYxKV9B5Gy7wk2nnnahpq
女宝宝名字大全,2108,160,1948,1,32500000,http://www.baidu.com/link?url=OPHv63wBOmONl98UzRWz6d9YIFPO5wP9-tkeKRvphxqVqBZJhGHKVGX_aZ673eJMB7DmGpHe8uS5eaJ7iICbEprg5WIN64fR0XHy2VporL7
周易起名,2107,244,1863,1,7370000,http://www.baidu.com/link?url=cckzHzBIWQmBSdVOpq7S3tEvVyRuPNSy9a0xtLINDROZg-ty2EII68Wy7KvBf6bb
取名大全,1981,152,1829,1,12100000,http://www.baidu.com/link?url=kf0FbhlULhi_-HSOc8vc8Emo8eYVAOk0dbLUK4MDG5L1ODFAPYbDIfa-H3axzG6V
宝宝取名,1950,523,1427,1,15600000,www.yw11.com
宝宝起名大全,1895,197,1698,1,7780000,www.yw11.com
女孩名字大全,1860,195,1665,1,14800000,http://www.baidu.com/link?url=DhMpLjv6J3t2eaS5FS54yW9SKBCtEa2k7uXwXWa1_7LwIQSoOs0tKEKn5mXONr7Guf1SGb53DDPuXGwuf8oBgUlsQNiAlKtp0T4d8kxLA5a
女孩英文名,1756,478,1278,1,6190000,http://www.baidu.com/link?url=TsJiMZjdz6fGZKYPo1rIoQLg90qiHH4inPZe97YBRyo6k_mo8Bqbq8QR9o28OtSVaLZSKhxQzVw_x45J1ZYNS05HZrSUahD8BtSx0ABG4Uu
团队名称,1745,156,1589,1,15000000,http://www.baidu.com/link?url=HT4tCot6xB5Pv7agXc5psMa5wv_XXh7IzOe77dQ5XXTKK8r8pXS27ODmv7coimJVZkNALWNiU2tBcf38iAkjw_
起名网免费取名打分,1724,485,1239,1,7530000,www.yw11.com
免费起名,1645,229,1416,1,8440000,www.yw11.com
英文名字 男孩,1626,705,921,1,4070000,http://www.baidu.com/link?url=CMNy4RvyN65NakEgS7KqcbzYNzYRdz8hP4RnHvbeEcYMfrb670cd2LRoycb2bsQhtHRFxBdllwOoOh7ROKkUwh98JLd8_YxTe9eQuadHage
战队名字,1591,191,1400,1,4680000,http://www.baidu.com/link?url=VxM_EKdl85YBoQjqUI3Iq-rvAh_m_HpTBMzlVYC-oNLZkknQbck5aE_2XrH46vnYvKNs6dz2c2EtoddCZp7gIa
起名网免费取名,1564,192,1372,1,12700000,www.yw11.com
男孩名字大全,1521,114,1407,1,12400000,http://www.baidu.com/link?url=bD0CH6oDUluu-0P2jUJVnotGijJcQbaUd9xjQQnmRM2Tp0ux4x7AtkpvkOrXL6kzpQumcajaNWAVnn8ONawrr5sx22OKIk373rbAFYpL_gm
起名字大全男孩,1435,174,1261,1,6080000,http://www.baidu.com/link?url=Cw9BCe9ShiG8AkQOjjJsJzodn2BkHLFsM_uXf-obVN7GPUz56soIkX3c42t8j8qcKqIlyA49dllqcGNCf3CsyU3ZAHkP2eZFy88Y_4a2YCK
宝宝名字大全,1400,148,1252,1,4800000,www.yw11.com
按生辰八字取名,1391,139,1252,1,10000000,http://www.baidu.com/link?url=J4HE2j3SIi-sggFYSD47H6niCm1OH-gzrld5NSRKcmHJL3vLpIhJFJFlfMLQv0_9
男孩取名,1354,165,1189,1,22700000,http://www.baidu.com/link?url=6lN83PJCRdP7YuWilheTzaemnxc67ZWET3uIti0Hy6l-T_QJYS46pvQ-r_L_OqiPuu-ghC9IhoBMwk5vxVxxx7gCqzc4_-N14qirFLhvU-i
在线起名,1347,450,897,1,9210000,www.yw11.com
公司名称,1316,404,912,1,28300000,http://www.baidu.com/link?url=6mOcStpkQXa8FjEms8kStS3dqr_iEjf6u4KmvpqBVxgafwYWaPrqIsDsmxjdH2spBLQX133p-CehnUzxynB92K
好听的英文名字,1303,454,849,1,5210000,http://www.baidu.com/link?url=yfVtEfOAS-WvU3Og-6bouKU6W1yEJY1ylGTLkUAWcDcB13ssIWLQ9-V5tfQokr8x2M2qj5KPH5YEe0oIQR3CQBd35J63YJbiioF1SwMgXGa
好听的英文名字 女孩,1282,245,1037,1,9970000,http://www.baidu.com/link?url=QXks9trQ32GsTdbRRvtdziy6HPwUkgc1N85fG15faU1WQq6gbq9qq1DowFOd3q0qwkIIsFF-HV9tN-npJDV5FGNVG-Od10-xQ9BuMF2LoMS
英文名大全,1274,195,1079,1,5510000,http://www.baidu.com/link?url=2EgtR665dF2rf4lcPkpqXQaS_YdI2zCM_1x4kHUbFS_MM9SLCj4QtQsO0JGK0aeUtIvMuq_fL1qKHERUijOtQUpRbmVQfFDVkCteNH91lRi
姓名测试打分生辰八字,1251,375,876,1,4940000,http://www.baidu.com/link?url=6orEan5TAWCfeHEvEkZRvBJuQlrcIivke-czu5JHumjxRSqm6Ckp-TZeQ1Yb9kyZ
女生名字,1248,303,945,1,38200000,http://www.baidu.com/link?url=KYdga6jdUgpujvdjJ9sNpx_pPGzzJvY8arHKt6x3rPP1yZp76aqNhKiMmyv3ps-NbjQd9y32XTVu_dxki5RifhRBi02evcbGo1hO4IO8dS7
名字大全男孩,1244,183,1061,1,8870000,http://www.baidu.com/link?url=LlwoIwESEVXD573YQnU7S1ewXNm46gA6U3asIjWG6F_6Fd4MlvbhljA-3kBtV8kA7Ao8S8l5DKpEOcYnmQllZiPC0HV1VgIU3ZjIwXcoC8e
公司起名大全,1190,246,944,1,11700000,http://www.baidu.com/link?url=j93Cv2gcwGVM0nd_4AmBfZciLErXQWjY162EhOud-pBbkSeFbFetzTr7YfV0erG3
生辰八字起名字,1186,223,963,1,9380000,http://www.baidu.com/link?url=zdnFe--h_8L5hESlzwfawNv17BLDg-10sWf11uJe4JeOKDPz58GYFkpd7D3ilUTY
宝宝小名,1165,154,1011,1,3230000,http://www.baidu.com/link?url=nFQ4rE5z_ruJQ_ZzDRhVR-WSwG4AhkWdhDsPObyCEhNtCggvnehI_SyWLaxUyhyFbwzKRmERXXbFOzTuNkM88JiCEgtySv-8F1EENlUKQfK
公司名称大全,1158,229,929,1,13700000,http://www.baidu.com/link?url=1UM2iR9aEerZTlz6iCJtCkiv9eqs3K8-YX01mq3wqVyG9R6mpoeR6juDEtFf5m1rxkaB0hHfDwSYVju-9_ueUK
起名打分,1128,161,967,1,9240000,www.yw11.com
男孩起名,1128,145,983,1,9160000,http://www.baidu.com/link?url=SwBemmNaXlUB9Y0dlWaWzXW2ZaDfi64YAG--ojN4T3Kl4ieYxiuYRuS_JzCKRq-QBBC8O2pf-_5C1eQPtvh-lOSIISUrAEoo0yczPriGFx_
孩子起名,1125,179,946,1,25800000,www.yw11.com
女孩子名字,1124,159,965,1,23200000,http://www.baidu.com/link?url=O1U7FpVTlfHgkASXHzeDr3CWS8LyFgOxMPZxiL-2UJ8wtJU-tuDKROmPPGCbUu8MrQt4sP7TmtEyiSQn3s60cf4Jbuj5omJ0u6wgScyEMtS
女孩起名,1094,180,914,1,13800000,http://www.baidu.com/link?url=Uvs8Ct5IdEyULJrrNhAalMKWuKba7rQ6Wqc84etcpP6af-EVemArHiBI-YGFMgxyK6_wwIsr_0j-QKbapu8D4WDjKNEa09bjyssD8wzGouO
免费取名,1090,151,939,1,5970000,www.yw11.com
英文名字 女孩,1075,821,254,1,3560000,http://www.baidu.com/link?url=CsfMmZ2Uu4q0cQozfowIiFMeGdeOMsNZH9B75CWGRxRti-O2f9X9s8-QmkgRXiAAfv8IqTPq92wMoE3nBJRzUSm6QWN3y3Y4DpzbowpfsE_
女孩小名,1073,168,905,1,3380000,http://www.baidu.com/link?url=eJZPD6dLjnOqB8Mr3b_i4JWJXmcZT2b3e6MRHpF-CfHEPEhcsvS34rdduBfiW60Nbc0FKjxraejD_FnPHjmCvhnOc3Lojty0bqz6oO864v7
宝宝取名大全,1069,88,981,1,8660000,www.yw11.com
女孩的名字,1065,171,894,1,39000000,http://www.baidu.com/link?url=eIUacXhJ8GMw7DEqxm3akBimBU5fmXGQqhDXwgCKIWlzaKf7bBjr_jSTFXWaGAz9Tpv9P25yA2uaS5IvCYPbaPNg5ALRvU1W2LJEebwFiWe
小孩起名,1057,155,902,1,21400000,www.yw11.com
男生名字,1054,185,869,1,33300000,http://www.baidu.com/link?url=_pIy1wD0eDNoSgySa-6MDA3yufEIx2Ju2JrkJMw5jQpFxZgXHAubgSQlqsfD_VA6ipe9EFAocdUFGbdSwBryIN0XgepYON8f9EumSXD917e
男孩小名,1047,125,922,1,3560000,http://www.baidu.com/link?url=ql4-jBx0lwt3J-jtuzxPi6oxJd4NyR6rn9LJajmN8tVCHMHT71r6VWQuY6BX5J8d
好听的男孩名字,1038,110,928,1,15700000,http://www.baidu.com/link?url=sGLAXbIfKKxm7N8l7jPXKKeTpId_aa89i54Q7x0653WGSZ10fy2uUDyabhhfeVGvgPWUDuJAvcEK78nvkg2Yv3SOdS092orUeJkLSRXWeh3
起名网生辰八字取名,1034,319,715,1,3740000,www.yw11.com
英文名字女生,1027,87,940,1,5930000,http://www.baidu.com/link?url=bqakdYfdZgH4DU-NW7qvYdl2pYxDlNrF10GdU1c3S4InVsrA7Ko5fF4Lt1-MBIobBqLSHJ-KjeVTpoO-tvP2Ey9_1O-F3KceJ4eRnHbB_au
好听的女生名字,1015,186,829,1,35800000,http://www.baidu.com/link?url=gxrUf621vw9fIoHyze5GkxZNdkaXxPcptcYkI-PFEu0R1XAzXhzWvs-edV6ZMcPsh42idqFWGiizuAAABzcdyBXPEBIrLmhD6_uD8Ncr5i3
免费起名网,1002,154,848,1,4720000,www.yw11.com
霸气的名字,1002,154,848,1,9060000,http://www.baidu.com/link?url=OEmXXGbRuru9NVZ1OogU-Mv43OXf36-dTLhgl0iFq3Mi7Hd1Ttz3JqftGx44XQZtvwKMqIBDS6WPBvvxxCjv_KiiFWP0ld9aNNkzX2gQ2Iq
免费起名字,995,90,905,1,4830000,www.yw11.com
微信名字大全女生,992,468,524,1,4100000,http://www.baidu.com/link?url=QgU7FdSzFIhBtGLIhrNKW5YaK4AkiAtNSEjY8-_XC7FhAfdf79iku8apMFPntNlA8HKBZgicvpzUzEf6kUS15q
起名字 女孩,990,71,919,1,12300000,http://www.baidu.com/link?url=GaOZcX_ZOpTCnQetMRTG1hKQKavOHubFqClHhnBLZwF32iuwnw2G0YUWk_WvwDtSUS_ioC9g5itHJkcytEwq62dIKvd4Nj-q7LGpsc-Mmde
生辰八字取名,990,146,844,1,10000000,http://www.baidu.com/link?url=rK8B78SWcp4Bgl3hjwmWoNpkV2ZDZJ_qOP6QUZsxWrSsFA5vf0KiNnHlZo3DbCHV
公司名字,985,295,690,1,28900000,http://www.baidu.com/link?url=U2EIWhJsPVgsSDesMttG92l29mtgM4F_sBua03UMNsCoO6qGeh-Cui5VStGtTFdq
起名字大全,981,101,880,1,12300000,www.yw11.com
小狗名字,972,78,894,1,5970000,http://www.baidu.com/link?url=3psTT42sSm4JO-iW6SZRgM9SHfyfFgLYuvFwrWRpe74sAPvlaTy99tzP8qplY2RvM3EzQxyUi2Oun8QsFpBN4a
公司取名,971,370,601,1,6070000,http://www.baidu.com/link?url=AWxerVvzagm3eQn0lQPgYwifeyyw5gAypOHWmqtVdQml8x_JA_dzBv0DaIocXt_V
战队名字大全要霸气,961,139,822,1,146000,http://www.baidu.com/link?url=Jz2RcReLBdCeawSXl2WwROVVWTWT9eUG937EvMqegWP_iFJieaFuaf465vut9SGJXjDAHdNgLWiDHogqm2vuztCcWhWUKfR-6mRms-PCEXK
梦见大蟒蛇,952,134,818,1,1780000,http://www.baidu.com/link?url=aPVCTyK6hIwPGRI6T8JCcZyPl-az3wapuk5Apy9o9LNDKQFC3uFdXoVxQ1LGOO2ar5E4sEvl355jISTN9ijdfq
名字大全女孩,951,84,867,1,6440000,http://www.baidu.com/link?url=1mbci5I8ga1Gb5dmG0NS5Ew8hs9js6HKe3jTQ2Ivws5UgER798cM_c8VOIcqr52m5N7o185ZjBZUd9e4eNJHtvY5V_EVLgaPX0fYqHubKWO
公司名字大全,943,224,719,1,15700000,http://www.baidu.com/link?url=9DgEjTw2dRiUVX1I6maIAsLnhynybH_xM6DjdXZc2E3nHmiZYRg5wF-tX0lfDtAvWq6ftZ-uN9IDUKvaJw0qtq
新生儿取名,939,86,853,1,7740000,www.yw11.com
取名字大全,935,115,820,1,10600000,http://www.baidu.com/link?url=bbm9QalmwquBdPXS_eKybgPi6sLfLvPGrSlVzCkQ8MfE5BU1fmQ5VX9W0l-63_O3
男孩子好听的名字,933,52,881,1,33800000,http://www.baidu.com/link?url=nndEEnjn1i7UEMLVxqNrXsyD_OsKhj-Zm2geEOMEf9MaDapkcyTmzf0PaYjy2gyCskNNau6_5DRFyWbTToQ24Pm846Jrf30G0RErZ4YWz4a
微信名字大全,932,97,835,1,13700000,http://www.baidu.com/link?url=szr1D9qv3XLJgFt27CwcXu1UWBz0QcWVHpD_NS0eV-SZX8VyTFHJOpdeEw7wOO7ypb5qBYf7kscoY5zYChDjk_
男宝宝取名,928,105,823,1,8880000,http://www.baidu.com/link?url=YJwsuEAGTBXg7JaylXPc_igcDjs_8_l05myPVf9jy9HPgB4p2frEn9DUapDcYFAZaAk2OdK35thHwDasQN96wz1QDVvhKnO7pNoOFBrwaie
服装店名字,923,82,841,1,3660000,http://www.baidu.com/link?url=IXswJsz4F1dIo81P5QgbI-WjxfUgZ7b0PUBbpnSzufZloCj2GZZfKTkYJK1ezA1Vq154MtlVCGYztGfa0TxNXq
好听的名字女孩,911,66,845,1,18400000,http://www.baidu.com/link?url=zC8NyYjafxf5I4_7qnA5YUCHfWFe7gyHDqpQDiG58kbUzmfFytGuRYyO7ve7ATEyl99aUvnRMM2XfDNKZTdlTdcd99eeoLQQc9nDdcHpGj7
女宝宝名字,905,74,831,1,23400000,http://www.baidu.com/link?url=wrbIH3H010TIe4MvefuCTVEBRZya331b5d6PzBCGZHK5oHgmue4rJO-MrVTpDlxq4kDwmI3Fu--Yi9Xh_3SLR_
群名称,903,104,799,1,5360000,http://www.baidu.com/link?url=Gxv1UDv52SCUtR_GQKb4wiS4WUOmfjTVrMpDMVU8hKuy19kjlExRCn2UnODhAFalhd20pTauu7sAFniIhFi7b_
宝宝起名打分,903,81,822,1,5550000,www.yw11.com
梦见坐飞机,897,112,785,1,2620000,http://www.baidu.com/link?url=dmWHTdGw0mFxdtzgMKMSalr_JTU6ugGYhng3B7OG26B8Ds9H8bt1nyawuW1LoT3XuXR1fGRMcDjb-PY1zMEUba
群名字,890,105,785,1,6530000,http://www.baidu.com/link?url=tik0hiMOMgNuSSXqF3Rw7FfXQtk2TUwwi64d9QER2TbUMAOnOwm5x0W8nESZEWp7YWhSqJ0ZHNjwohdD9JMGppUxjpxyC7blBjCFezgHaWG
王姓男孩名字大全,890,125,765,1,249000,http://www.baidu.com/link?url=fKDf-H8OSGPR2M86njLVrAml1LR8EGiZhzT1N4PwaS9kGXEA5G2gPJrWFOTdIwg3V7KK867voZxSkZ2EVs-B_a
带木字旁的女孩名字,887,94,793,1,252000,http://www.baidu.com/link?url=csmh3pzHNUpvrD9FVI9M7o4IAYDJPtebPtB68W8RSzMMKrMCihvCgK5EhzVAmGhrxSlM1F8h9t-PypMRCvXhRAF50CN21ZUbKIxJbJ4loH_
取名字大全男孩,886,85,801,1,7240000,http://www.baidu.com/link?url=MyxNXHvbmN7eoQlEHajN468iaafw_uyiO30E8Z2uAdcYa0-doH-Zhwyh1QphLPAur-D3hPK-s5gCoWyh2ZOrB0FIW5nfhZoMOU1ZkEjPWYe
带木字旁的男孩名字,884,118,766,1,515000,http://www.baidu.com/link?url=Sq3q34CjyBfSC9JIXy1F6UtUsFl60xFGjs3Soc_fE6aaKPcoMapw4TVjbcZWmJOKN8sr87ZuCiGPxFz5LPk51pBvpboxZKPFS_eMTEGsYva
小名大全,882,124,758,1,7440000,http://www.baidu.com/link?url=COiFI-mXGUjp8XEmPiqnXZvA_gDm7bSefXGgnXN4BdKH4A3vFpcj6ygBJPWIGRfzeCrwrgpPwGUEFc5LiHfZfl4-HnXLIPYr6F7v_mLu5d3
女孩取名大全,855,68,787,1,4560000,http://www.baidu.com/link?url=a0OGeWYHz6l2nYoURIXGtHqeqrP5fFLCoPQaLoPSX7hlZaOtan_QFXtyniL4KI7bdtk7SoCzbS6kKK26d4ip75l35ZZksBtwGBuWsVEzjri
小孩取名,848,204,644,1,12000000,www.yw11.com
刘姓男孩取名,846,129,717,1,829000,http://www.baidu.com/link?url=vgAsEDRR4R3sWVg_HioDEXgfnUECvtSxYo7eNDWToiXKX1w4l-MONgoztWKXH7Usx6aaEdDAbo-_U9eZM_gq6q
狗狗名字大全 洋气,846,119,727,1,4550000,http://www.baidu.com/link?url=yvna28GfeGorVJZ7nVDp7hubFCbCXG7D-ouR4qM1tE7_f37ecC9Y8-yxD4yq_Ft3VgDPaQDcZ7kioOhYdj3vnq
女宝宝取名,833,100,733,1,9370000,http://www.baidu.com/link?url=c8WulVpcSqr43_EjyqG-EABBi6B44_W_nT5fOmFGye-NlSaxGdjVkl9hRo1E8jeULx26YeuXKtferntJh5hbqa
新生儿起名,810,92,718,1,8580000,www.yw11.com
宝宝名字打分,808,103,705,1,5040000,www.yw11.com
给孩子起名,807,77,730,1,7950000,www.yw11.com
英语名字,801,182,619,1,20000000,http://www.baidu.com/link?url=4CcTmsJaP-kUwv_hCuTxmwzBmZSg_e20qnG5Zi3sB4Zn6vPyWx4Wr3zLYIus5aW_RctMiJTFuvnj1394c3xuyx_VrCJZnjIaQCTlfMwbzVu
战队名,799,116,683,1,1100000,http://www.baidu.com/link?url=W16_Z3eM5Ge47tZFrJbl5aKz0vCwnxAFw-wgENlbACBmLjL_SQPVGsvxVXvlR-Tv6nwP-bc_yVtcO8ONhLcv4q
张姓男孩名字大全,794,142,652,1,1040000,http://www.baidu.com/link?url=x3oylhfAep3LR1DPFDdoyQmbk5duDLvmYIgQ7aDM4sAJxh_NH2s2kD8UC2RpH1-QeCJRE6kvdGLE1vDwNSipEa
带土字旁的男孩名字,766,79,687,1,387000,http://www.baidu.com/link?url=CZe7pI3hUZP_dg8-P5WSPUVP_-0gdK9hXG2hw_WpI_8HS4ziTNpOBfnXWkD6sU4_3A3182FFlGD5-oJie3aZchCC-Srh6Z0PW-G3wdP0E9O
王姓女孩名字大全,747,102,645,1,218000,http://www.baidu.com/link?url=TAXxwd1U7-jxBuuo1NfE3FCKkq_MQMN354-9dPRrC8dFRAVMMcI2rf0-Py70wS99BTQ9eVjJU1mNG3TkNs4RSuZnAVc857cMDR4iWzkqHAy
易经取名,737,85,652,1,5860000,http://www.baidu.com/link?url=xYNbZ1Zy19wpTa82GVs7k_hNpWoxIxLm5_Mu5cE9xc45cUt7nTrNCKGn07IbJz6XlVVWYX02cPmBsb3O2FAGVa
公司起名网,699,408,291,1,3930000,http://www.baidu.com/link?url=6tIbnkwQxqNeHxUQVwdFrOUz8ZSNmD0Fwlr3Ggv_GxRK3rXuUVF7g691ZEQY0igI
梦见蟒蛇,694,135,559,1,2380000,http://www.baidu.com/link?url=GcNtD8EoxgRFgg9TGbvQxksECYQlEMA1vFsxbKn9lKDlLhxe0OTSSAD8q5Lwvd8IwsHxRnA5CYPh4yZqrs4bh_
取名字大全生辰八字,689,62,627,1,9870000,http://www.baidu.com/link?url=XZSua4YAi3yZWY3BPZrv9dN_x8PEBnKR0YWTU39OoaHVZvA2AywUIh4OyFbsAKB6
好听的男生名字,684,143,541,1,30300000,http://www.baidu.com/link?url=1R05jI8pi73qcKnnK2g6CuGo29LXcjpg0vvRriKQUPQVueefKhwAGizyS1GXzSj3nBQGVTljGBzsJUGqy4MaJFM68rFJZIJe9nXD-Uf-gz_
淘宝名字大全,684,90,594,1,13000000,http://www.baidu.com/link?url=R_xzraSPI-HdNOfSboCmfS4KWRQrCMizmhdtW8VVqNmteNBnAUNw_g-_I2PTDT_EdCT-e8u8S3jG8IqhH8PMo_
给小孩起名字大全,676,77,599,1,16600000,http://www.baidu.com/link?url=b_iQDHfNS0lXU00QAqi9EPif3SLg_xWG2MuNmV14Ew3E8X_i1yqnGmxIK4QlzxiJ
宝宝取名字,670,219,451,1,25800000,www.yw11.com
男孩的名字,668,90,578,1,35100000,http://www.baidu.com/link?url=PcWdp0nTO_TZ3-_i6R33Zn_aL-B7uiLt6JLSgJ_h2noY8hpwRZ4Fgf64Pxmban4efCSHWmGxCjPACR5h9hed5QPCm9kX0gQfTnCpmV6u1iW
lol名字,666,240,426,1,7610000,http://www.baidu.com/link?url=yJl_0TGo9djTOE27cZ3YOb9tNsraHUEHDBVwxlLPNYprQEqxbmX9jzuEqep6-cKQrbTblEdWpc886aLzoFzXMq
饭店名字大全,660,73,587,1,2420000,http://www.baidu.com/link?url=1mhYAw6OsITXyXt7epOpfJGKRHwAYvra2UGpjrpYYBhUtUJfNWV6mw5pqiXOSwxynS-nU_pU6bQIHsnvByRMJ_
英雄联盟名字,652,207,445,1,8080000,http://www.baidu.com/link?url=nhhSXjoSa4tH9_CaLwqJlTE7SfW6nVJQwclHXYH3kRKkFmgma4Oc0Jy7QHPcgWw7Uf_3AbIV9yt6fh1-UILLgq
店名测试,650,65,585,1,5530000,http://www.baidu.com/link?url=EH7ozjD5MywHTMv2ODrEDZlsksFXzMiVcfy_iM-R4T9AOFuazAxE_zSXyQ_MkiJca8SUESOXDo7-ljMcKm01oa
笔名大全,649,120,529,1,7230000,http://www.baidu.com/link?url=D282kshORRClxkndiveEWwaXdPfHAvKhkOZM1czcXUs6xidahKJuNAbVUl0xQZ3sXtybpvtFXy02DZzIVOExyK
lol名字大全,648,228,420,1,4240000,http://www.baidu.com/link?url=0rWVeJ5f8YKu05rFyXrX7GoQaSsqHOboTSglDbyH9jSdsz-0DgQ2Il2JqQnT2_fjorgg06BXY7w5koIG1ZnJPq
男孩英文名字大全,640,70,570,1,11100000,http://www.baidu.com/link?url=2wijP-_PHbVVpcJD7PCRY6P83bIXTmGobsbhFBhyfrA-ZU7s9XdibxQ3LrjmzUb5dkD8MFY7jNhqOuqioyA5JjYYojEl8R66jUbqMCAOZ5u
女生英文名字,626,122,504,1,3750000,http://www.baidu.com/link?url=HKLBqo-xMe7OPsbSk0kQl7TO5yjLKya_YW4MG37JhDuzexEDlMaQFA_HGoxdOhRqk0jO4O6oPQs_rm0jQveJvr2jHZxqOfK9eGOjPe0nQAK
饭店名字,622,69,553,1,8160000,http://www.baidu.com/link?url=Wm0fxkEm3cc8fubYnr9XXGc69nVQJMsHp7JQS84871bORU5bWNN75q-BtljpEebPhbF7GsryLC9dNoCK2tEJ6K
起名大师,621,238,383,1,14800000,http://www.baidu.com/link?url=Fw9wp1azySwZspZ7E4CGik9o81jtmMt-zXlqJjHQOqQ3DEFKIAEgm54A209O2xh5
男宝宝起名,617,124,493,1,18100000,http://www.baidu.com/link?url=dX9GVLp3WZ57cwnTrFOVCw0Rtnrx4TA2eOBgRIQqHTInq5tR3hSl9GTDNxg59ByCaUQ62d8QHgbyIB8vdAAFkRbvCBStrz21GDcIES2h8KW
带土字旁的女孩名字,604,78,526,1,253000,http://www.baidu.com/link?url=yS7ntrrdhxHRzI7eOoXLUzaM4OPszZdvKFGWFfpeqrGhQRlf_zANdicZtzMeCo5mEMZvH72fC1KqHbYc7rNxwBk-LtRVuT_SzVTAcjCASua
男生名字大全,602,86,516,1,15600000,http://www.baidu.com/link?url=eAT39JMgfbYnHBBOOmTqV3KF6tTLF5y6WWuuWHYfrkBQe-KjxflMiBfjC1yRzs7N8Ri1DJlL18_AzZJSmuxKrNrEADzBsMnLy-JUkbPctbW
取名字的网站,595,465,130,1,23600000,www.yw11.com
男孩取名字,593,86,507,1,28300000,http://www.baidu.com/link?url=iYz0ewc3PKxAgIKdtgItiniTNwQp8osPdFQe0unmIILs9Rk630cjqy_U0PyTskTuzlFn0_GuJBRlG6tl4Qf2ngRoYsNI0YuHe4Q1Vjh0gO7
狗名,590,83,507,1,1350000,http://www.baidu.com/link?url=PnAbZ57Ia5B2k8NA6MXVqZ5sy4c5nRLk8Ufi1keJwTT7zxiw55RWUhup9Vdl32UGQGpT-lp8rgbX3x8Sj4zTbK
游戏id,589,219,370,1,18500000,http://www.baidu.com/link?url=T02r6eGgg4UY6rsBoEGR0wGqUxR8VLVoqoStdV6YmSey7KHHTjI253uWFGEzZsd1SOFBevGJ5g7rHIKwk0Ekxq
a开头的英文名,584,112,472,1,2100000,http://www.baidu.com/link?url=WkFw7TpeoincVgGrIb6QlzwzX5aesxjKbFXgy0yFwOOeeCl4lcifiIRjOC9WDgk8oFzV4EYVIOp0tON7e-D3xSsG-BX3xxwSQqh4IKFswA_
宝宝起名字,581,215,366,1,23200000,www.yw11.com
新生婴儿取名,581,162,419,1,760000,www.yw11.com
婴儿起名,576,116,460,1,15900000,www.yw11.com
梦见马,567,73,494,1,590000,http://www.baidu.com/link?url=hA947yrU3ZqD6euNvmg0zjjKBK0RWzynTaSB9s-3VWvS28DEpGM_lQZahkAnmRY1C5V_PUNZq9r9jr2eTYWXXK
好名字大全,563,62,501,1,21500000,http://www.baidu.com/link?url=Nw9F04CWme4shk8hDS_643JPsRaFV4SmsO9-VXp7UNnXCwjo6SO8qQ3HIuVvxn4F4wLwFSs4caKWkCjv3Y0HLjCNtRPV1tofTMkaPvNuOnm
团队名字,556,130,426,1,26200000,http://www.baidu.com/link?url=NNI5YQZoQuvo4h0dhhqEKxqHQowA5Yg9DuvuXH29YXD7Iue0LMxGN3E41KNcNv3FOJdSlnbNKotLrA0476_aO_
好听的名字男孩,546,53,493,1,10900000,http://www.baidu.com/link?url=D9BMDv-J05IOspKPTcJY3jifzSCkzdpVNeBVeQ-GdNtcKD1zY0rYUngMGiBPyXJ93Z3ZY6ByPiI7F0Gtyxh14JhtXo_QSSOq70m7bppa1CW
女装店名,544,89,455,1,2770000,http://www.baidu.com/link?url=KGGJG3JUgHCabLAJDYebUHct9okOCQUy8XDlI_0I1C_S6hH1fBqSPdRlJ5rA2is6rsb3CBTAWm4rtBbYS_swBa
英文游戏名,543,170,373,1,7570000,http://www.baidu.com/link?url=6-ChXFr6SikhBqB26NWVPBvN0__2C2xKMo1FKnJuONcLATSTttfrLS5jmwzw2ppDDZHL-UT5UYbQoVjTh32uL3K2d9bt9IeUtirnX1Uc1Ta
水果店名字,540,81,459,1,2960000,http://www.baidu.com/link?url=yIaurY-SWpf8Ltkzb1TQjewYAvCIm8RGsIZA4BaPQqDRisbyqe5Vr5HKv8FhV75cLBv1ikDIuKhtHbltNTKje_
理发店名字大全,539,43,496,1,1150000,http://www.baidu.com/link?url=ZGVJWbG2kzUh2HgTu1nYBoKIOlIIs8jNwj_Kv4VbDodGpr2Y-cyisK8yrVDafaUPraJnyHDkcbx4q1JtXpQKU_
小孩起名大全,538,55,483,1,4350000,www.yw11.com
英文起名网,534,421,113,1,8100000,http://www.baidu.com/link?url=u2pdwSK-AqXvt_HCwe_Ng7Grd2Ksk8zsRMMKRuMhbFrm0k0jDiS7VOHdia0Zk0WcwrZ3eH-KDCjv6OnjRUKZfUb0ao6z5IzxEPLMOPvVcC_
男孩取名大全,532,73,459,1,4080000,http://www.baidu.com/link?url=h2AMsvJIogE1z-ed2aiVVgO-4jcUFER-fgpmSux_AB6Iumbf_A679y1wpY9dsf1sPzn6whxTJ_09p9t_FKaJTcftDPKlZoIswmDClp7lQc3
战队名字大全,510,281,229,1,2430000,http://www.baidu.com/link?url=lgp9QR1yRrxCuZB6iHGTi_p99fv1xjXoFaJ6MkYgrxukrmAlSwS4mYUD2tjNepJEO56Xj-te9w4myzzwo5r0QK
美容院名字,508,68,440,1,2990000,http://www.baidu.com/link?url=n5Fa-MoWhDFnlyiwxYSfR10a1T6MKaFbloHlbajKSpyFybTvOghF2DYr-Ak0QigFNnqCrGTkGqHKV1LQZN74Tq
好听的小名,504,82,422,1,3260000,http://www.baidu.com/link?url=YSPIbovlxzJCYnSXwkTW5w1V2zoKGOPVxb7XesanFxO4O85aAoVsgY0_Pf-ajvV5K3z323mRn95Z_Cc2dfiSpC4mImEQBaKC-bGcHWKWBvC
女孩起名大全,499,25,474,1,8180000,http://www.baidu.com/link?url=DMu7xxA-_qM9nOMbVjqtQf-QfsWBSE32KqxPqq91B4xKxzRxwv2rwqm3YN2aqN74r7twCmjJWsIPphm6Yv_p9RLFUOqdQxBDsUffejevB7e
奶茶店名字,497,66,431,1,2890000,http://www.baidu.com/link?url=DKmtKy0YKd1VnrGlaMhv2EEYlWXUP-89QnsOZHAj5rtpW4kB0omc5IYDj9eOe6-4xk7ZI-zxR0XOQKrim2_Xi_
花店名字,487,91,396,1,3410000,http://www.baidu.com/link?url=S638aKoVDJ3u_WFeDbp3fwbkWtukitpe-tCdfDu9_K2Bsd23GhBc6B6nEGNX6BS9ShTLFd5X-peREA4_CTrel_
免费取名字,480,97,383,1,17500000,http://www.baidu.com/link?url=KUhqNgKVjuC7A-a3mhUzKUwHbTFY5SM4icDcVUAbfc7cb97lxO2HzSZ8HKMBU9MC
蛋糕店名字,472,75,397,1,3060000,http://www.baidu.com/link?url=uecbb1MqSUiL3yDgtiRNCW0l5bMWycy4Z_ctvUvQJEIzB4tHopyEZdSRkXsGf6UrWdmJsSSarJr7Ybjfcdb_3q
男孩子名字,461,108,353,1,13600000,http://www.baidu.com/link?url=m3t-MM4YG0amFtQPCroPAvDp1vGyMcO7_YjoR67RMIGEtnPhSGqJAp6mZF1H1llQpDvB_UuYbjALSvFmf9jkfv55H5S9bo8I2UneBspCmrm
企业名称,458,140,318,1,26800000,http://www.baidu.com/link?url=k66r46WGRLrTCEKOar8A0s1tb0tXd0-T-0ZfJNkTRLmRjXNeI7gPAXvftTYOB4XMdus7S3x8gGSi6omveKTSqq
男孩英文名字,457,88,369,1,4290000,http://www.baidu.com/link?url=n2JRgK0YHrM-vsXPjppktp4AUY8R0vFQ5gviV_d1Ftqgw66yBUp-TcZ_9ljdBZtY7hQirw17AlDJG063AXZgi-wyoygI9nzSY0VH0HpOhzK
游戏英文名,455,104,351,1,3470000,http://www.baidu.com/link?url=3WKZYWZI5qsbPNkTijC6qRp1fgbQUggPk2RZn-bCssgSKc0i5D8jQ_bZiYpp5e52UFYgkGp86UV6NUvw9oeTYvqIDgjTNN-GaJacb36eUqm
帮派名字,455,154,301,1,3230000,http://www.baidu.com/link?url=mJ9pWbN23HvufHTDpMJcECU_qZxWeC7KI38jryWBeVmBudypTlgUGGtC3l9J4dFOFyF_Me68mJklTV8l7OIWi_
公司起名字,454,113,341,1,3400000,http://www.baidu.com/link?url=XLokQXv8vfV5iAxcNIAXN0FDoAEQCAdmHXrdcxYV5NPZDnLKHUR9YFBQ0RLBml-r
中国起名网,450,152,298,1,3830000,www.yw11.com
结拜称号,444,89,355,1,1360000,http://www.baidu.com/link?url=gX0yLyarMT_pvcJme03mNkzReZrGX-P4NJVGaxuYAKVU8NIH7px9rsdY5DbfrAbIfXOvhp4U_ZmLOiyy684bk41BX-RD9MsKjN6bg8ZWs_3
美甲店名字,444,52,392,1,1970000,http://www.baidu.com/link?url=7pX4p07QnrELNMnzFp8w_uQhwu5D0UbNBy_WAePXhkemxPQ9g4GXM0nRIsGfgwcb5TZdcFvu3tYqWXtvLM0Z5K
群网名大全,440,44,396,1,3270000,http://www.baidu.com/link?url=uXRe7fnk-s2m1p6HC7agTN04U25FaxOr-il87s7PEfZUof_dt1YQecpQ3k7pxsPDy7nwAndRIG1UqLMti0O13jWDw8T_rP08Y3B8OipsiJS
乳名大全,438,81,357,1,5050000,http://www.baidu.com/link?url=s41tt2y-xZi7_gUifke7wskjuLpz5T7C6zTalLjdMlf0wGCqmV89DaRaEZ1NLUIT8au5_4XlhDz_FS1kTVnufCb93bcHsLARU2E6VJ5jEvW
婴儿取名,435,115,320,1,15800000,www.yw11.com
梦见车被偷了,433,62,371,1,2160000,http://www.baidu.com/link?url=2SWfzC8xXaUZ6pcYFDhhPca0smwSIupF8ahxgyn-OKEo57LBYvEY38q8TfIbCmvX0P_9yj-aBimtLXY5MnQl_q
有寓意的名字,430,82,348,1,5490000,http://www.baidu.com/link?url=-CCxKwmfnUZdezjaMnD1idD8vzrfRjgvN-fvcoPrQ_OPrHWQ0sIRrMq5K8qk_j5Hok1ZBwlNiEbubeQQUlhCrgsubcjHHcBsdxE5_YnBnsi
宝宝小名大全,429,92,337,1,2610000,http://www.baidu.com/link?url=vbXca-uKkv72R98t-mAyuTKGbfG6ImsM3ipP66r0AjiIr-FRKtYxDNnltbuMZWBpJc_DgWXOV3VxcN_ppqVaz1lkpZkq16km-wAdvJPDcE_
小孩名字大全,422,69,353,1,9170000,http://www.baidu.com/link?url=hr7CDgtxFNfat2JtwWaD8GVhURxgoFvHuFOC-gLYzaTqKc5TGKCe6sETrYEIAwLVH1Wp-VGS_mhu3IAOrGHTxa
童装店名字,422,71,351,1,1330000,http://www.baidu.com/link?url=O2aJagn8nOOECp8xZ0dT_NErAMJ5V0GGqG5UuvEYxWfChiAi8Na2CaTJn_r_450mH2WzNfyA8LaylW7BSVjlmK
店名测试打分,417,147,270,1,2890000,http://www.baidu.com/link?url=_-YOcRV4idY0fdEZZmrriqlDG7eTXAQkWucQuZTRKAEbaFlmUEvzX9vAUgZ-pmKMLoPAvNaHOfBW1KP2zDYoga
宝宝起名网,415,114,301,1,5120000,www.yw11.com
森系网名,413,87,326,1,1020000,http://www.baidu.com/link?url=WsQlQ7KGvVmKDw_kQgaN84_Q2Hzf_NtPUFzU0JNxHUrz6ptW9aJhAO2083gDnTwK7GGTcx9BcMjFDf4q_U9m8r--501ewZQ--GFB7c0_ZFa
给宝宝起名字,410,73,337,1,9610000,www.yw11.com
霸气名字,408,94,314,1,10700000,http://www.baidu.com/link?url=t9Ux05LfPTe4wqPQe5ibd6W-fa4k-NtFcMUMWZXjbeXss3W9cbKOLjgk2ajt3ks2Crlz0tvSmibtxJ9ejCplsXy58VdVQW063H9ZBjTNqDO
好听的女生英文名,408,107,301,1,3820000,http://www.baidu.com/link?url=axDLk2DVVI1GzWXaL7sYsD-q8STgcFa-bmf37Zx24_M8W698DYHzS-IXzsVe-IFVjicbAp4GZNzp-aKbih1vY8w914D4fLbt-5NPEWG5U5a
女生的名字,407,95,312,1,26600000,http://www.baidu.com/link?url=QRrmlZjWPc8WlbmsN6BI2svzD0YRF3zkLfpw7fw2TwSCSWW0sP_h11bJ4wSew_Av51_fFiaaxfSkNpzPF7hqoTb-bx396aF-G_Eb10A1ILW
结拜称号大全,407,141,266,1,282000,http://www.baidu.com/link?url=vR3GmL7a1d684U0wVNknHwS1JVBGRu_ZIcN-TTRBjJ37cmA55xJCfkfpGNyysBxjmUacd2e3ujUtc5U72T42EujCQOjdgr8-xi8sLoQOhZi
英文名字大全,407,173,234,1,3910000,http://www.baidu.com/link?url=xplc6XUVDQHDHdsB38hI2q8CnO7Es64ayG51Y00_ivdiDUdR3iTidvENkaNFhgKem9NVIc4z8FG34SRcBlsAdY1KNmdR-tb1TQwpgyR4-cW
梦见河水上涨,404,38,366,1,96800,http://www.baidu.com/link?url=SRETYc0A0BTwbBrM94r3OFoly06q5L-fqX64tdcUuw_KL6T-rfGumFBbN_BXT7LMKDpDMRsdODiMhlH_1yngNq
带三点水的男孩名字,404,71,333,1,217000,http://www.baidu.com/link?url=STsIIwTdXs2xRQLR0MFoochwb38gBrHu8aZJVqWMtNOdAGdVDbnaFTAZ4d0YYLDTYMm7jbIn3b1zLTHi9Rtm_wuJsK0kNfUeivhMqdt08Se
孩子取名,402,126,276,1,14800000,www.yw11.com
游戏英文名字,401,147,254,1,4870000,http://www.baidu.com/link?url=QndRpl5ZpmiU63wFOQo84ehv-SDaiRsdHy-fOK7TE1XnDDEUIjVGM-uj-6TjTL9LiD4sySYLn9IkFg1PC394qt7ttip-3UtJ1jCNaCII5cm
周易起名网,399,193,206,1,2020000,http://www.baidu.com/link?url=YMc1Wk_yUEamLanb4tUqqOuGRFbWXzSvDsVap3Iy7xOG_-tUxHGOp2Q6rbKU2CR8FNyPN1UyVazeYlhQpkAQz_
小孩起名字,398,89,309,1,14400000,www.yw11.com
英文游戏名字,397,98,299,1,4250000,http://www.baidu.com/link?url=zkSy2xTxqr398xh-G8M8SpHR_F8XlC32gKUM7WMihT__1YMN2zqurdtM-NlLfJh93_BS5z8uMdjHLhv59zGX1S_kryKPL-E5uEzyc1fDgAa
婴儿起名大全,394,68,326,1,4620000,www.yw11.com
公司取名字大全,394,44,350,1,15300000,http://www.baidu.com/link?url=LCOVOilLaHseobrVq6LdPLHFuLv67COTE5KFDQHM8yIV5CTI54Pju2mLHAEJZCQcNUUHE8s7KzHOgvFC5IyK_q
科技公司起名,393,168,225,1,11200000,http://www.baidu.com/link?url=ySovL_Ys4w5a_VDyF6P6BCt72pmJDczaSVNsoRbA17zk7jLnQt2wywIcP9o2rLLC1mw5JwdBfEt3hnXcwXtT8q
女孩起名字,391,77,314,1,12100000,http://www.baidu.com/link?url=ZPjYppKKnQSocDV03nI1YHGRNSJj2eseDlviLsrvPyucikdy0HvuinwMHWCnJUfEQLNXvml8Ly713XQne87lTwQjC9MhuJllVzd1ZhGkvTm
小孩取名字,387,88,299,1,7060000,www.yw11.com
按生辰八字起名,385,81,304,1,12200000,www.yw11.com
女孩取名字,384,81,303,1,22400000,http://www.baidu.com/link?url=IseZwkhZuxi37jBvM5gpfha3RXV8Koa54jo7NpPpPzlwZlLMImK_7J333bbb3JzyjTunh2ATTusWuPniGtnClvBg8XHkwySRxi_O0daJjZq
群昵称,384,73,311,1,4070000,http://www.baidu.com/link?url=-cszgGS9g-O78nk2qZgzn4RgKOoL4qgf6RVaVik8jdokMNLygjUkz5ee_nPOF1Sh3ImqYdRx8eMOXqb2I9vYKE4Ft1dqXFBi2ouC0hTF4TO
男宝宝取名字,379,77,302,1,14900000,http://www.baidu.com/link?url=bO047-Ba-FbrSqRrRFZb4nUzqlqYLFCqNssrcBZny7-ychjcW8lkRJfGeu37nH9y3EEkNqjw4TUKv3HStc45fA9up-Ju-4haThcn8lDuNB7
龙凤胎名字,374,45,329,1,2150000,http://www.baidu.com/link?url=yenpfOMmo_QC6zbBqiOEX1UxsXnjJsd3kR3abvwoCI50CsCTlL2y98B-Mc-eU04_dMnbkUKKzZBzoT7_1-6qQiMIGcHGIfeGfb3W6b82fS3
给宝宝起名字大全,374,220,154,1,26200000,http://www.baidu.com/link?url=Pu1IK_IqliopQbk0djnhcgYz4Ix3x6IATToifZE3W766qPXY3UDbfImS_t6pUUJu
梦幻西游名字,372,140,232,1,3120000,http://www.baidu.com/link?url=LB0uzQRW_fQ-oJ0KrzoUqGp7Pdiegtwa5Mz84D3PgTGjAy6jBKDpqQHjpWfdnNOZZwPo-vfoWJ5xAOf7Tg0E9eShCsCEehtwPszon-YnELC
企业取名,371,96,275,1,5390000,http://www.baidu.com/link?url=wvDfHnK6zDP-vbhLFUsP5xjEAEk_Cb5wCb5RjrvHUujdElDkXIWqmE45mCs17Bje
好听的战队名字,371,76,295,1,1520000,http://www.baidu.com/link?url=JbkN3jh6pISIjaDFtkOMTgNcv1bqPEL8cHLmloU00eO-h6KbtQT_x3VEbcRz3fwRRtUhWuomvjtY47No0oHUbK
广告公司名字,370,105,265,1,6620000,http://www.baidu.com/link?url=tTZIyMxHr1h77QrtPnAygSz2i5y9z41_-UMUastJ7Y4iugse6bCIq050KHHEszWHkmEhKHRlzadm2u4U4FPM6a
女宝宝起名,366,110,256,1,18100000,http://www.baidu.com/link?url=8JwmbMZHPvUeYAQpPt7U64OQBybSpWHe2aoKifbQ6c4zOgDp1sczNxbb52gQ20MrLuxToUgz0TMQeT4q8XXz1_
木字旁的男孩名字,363,105,258,1,1720000,http://www.baidu.com/link?url=ciIPvQJz8nD9lAsXARl3KXKmI0vAu2l62J5gX70d-QHszpnYTp0Cjz-dYqEArmoC1ZKxtrz5BLDk7Weub7aUBARmPlGz68fx5-xLbymrsTW
家族名字大全霸气,361,75,286,1,14900000,http://www.baidu.com/link?url=npoWY8s_qpvsjAUttVFXbg8lHQObChsatFLGs-2fSq1ZHK51S6mYB3a_b5CjGPdU5zISbnKt_p9rQvWWgd3cCa
给宝宝取名字,360,87,273,1,11700000,www.yw11.com
免费取名网,357,110,247,1,4160000,www.yw11.com
外号,355,98,257,1,16600000,http://www.baidu.com/link?url=MJFoiUqkOLw1CpNBc8FYUJrU_O-JjhjJKKujRClV6zzjtqcU3EOndoAI_bQLOLqbNKok7AsK_PHx5iKdF1gxba
周易测名字打分,351,74,277,1,2790000,http://www.baidu.com/link?url=YUA4CwieQdBqphBT88Z0pZUElwpniuuKxGhcuJRJda9gsolZsUQdx-MbRASAE-sB
好听英文名,351,91,260,1,3750000,http://www.baidu.com/link?url=ga9OSEYDA8WbIL892OmHvoKv1kkBSjGs4s37k4fHglt5q-j2SgyFwS8U-_SKTbqSBkU4R6xHXaheAIa7XZgxKeJ3yNR4b46mi-w04gYLyu3
宝宝取名字大全,350,204,146,1,37900000,www.yw11.com
工作室名字,350,88,262,1,4840000,http://www.baidu.com/link?url=m89zxhDM0Herl5qzD34VbnZLPN6TY34h3Qg0Xhi9S4s_HF58q26JY0IWcFMZUjDkGabP16PkvZWw66QYQxTWJq
小孩乳名,350,69,281,1,3020000,http://www.baidu.com/link?url=VqBW1aH5aMhBAkQBwk7SKMO8kyJuq2uPeJx3XdLgiTcBtBJlGMojZNXU5Ce_346PRkSlJjm3gzJK73_pv1DcxXTPhEKKNFqHKC_xnmoUCkO
如何取名字,349,97,252,1,40800000,http://www.baidu.com/link?url=AyDvbI6DUoI8XDNg9FD-JHPXLC1y6APobVmUV7s_xcHGZ63jFJiEAlb_DdKGKvql
战队名称,349,66,283,1,5760000,http://www.baidu.com/link?url=T1-bCWQquVAYQiCSc_yIUXNAi6oPRRzI535tH3L1Z0ALFG9VqMxfUG64FdcRnypMk9EOt6qZsHiAfZhf3QUN5q
小孩起名字大全免费,349,101,248,1,17400000,www.yw11.com
最好的男孩名字,348,73,275,1,39900000,http://www.baidu.com/link?url=vG4GCG2VHBKb2u1Mq1aEbd-sBMYKoCAMDh_BQk555aUwTGubiRVlV0MSgW6-KXH1SlSMAgI7ZqASR1d-GXOdfASNVYNvly00sCIBdzrCIEK
女生名字大全,341,27,314,1,15200000,http://www.baidu.com/link?url=O60cS95bLbEDGSp5kFM0Zi1oj2DObx5mfojGkgRZRSXgSV6H6vL1DOHddRmzGZym
梦见花圈,341,54,287,1,1020000,http://www.baidu.com/link?url=zoRAwg4WB_H8PcZkzH8YXROTUPSzD_g5yUuedD7iPnv_hWnsP2oxZ7k7IOg8uuW5aGdphnsN6t-qfprbkwMDQK
在线取名,341,111,230,1,8130000,www.yw11.com
男孩起名大全,335,9,326,1,6910000,http://www.baidu.com/link?url=qpdsIOTjSIJTAkmL3rkL2W8ljBiiIwjPJWbvpuJZiflYaWqn5X_Uwg5olVs0mRqzjvKd0h_C1XrcSDO2GBkstyt59Pk0KeiHz_5xP-NgrPK
小吃店名字,335,36,299,1,4020000,http://www.baidu.com/link?url=1esNQUiksVlSt5TMwvnxC2awzH3l62Qnuh3Gv84YCdR_6tYEJpm_ZPL2gN8Tws3CANppxUhZ9qfugtALObn8U_
6个字的游戏名字,335,99,236,1,1060000,http://www.baidu.com/link?url=W6KTwfSoa84v88vBG3PT7brdbVxt60kPNWAztXrwl1eZAeLsiRZijG4d_UhLiH7lQnYX43yaQ3ka4COvNquYqK
qq群名字,334,76,258,1,8720000,http://www.baidu.com/link?url=xNe6qjt7Pj4p1STRb-Lg6qHjX242iblq_gMR0E2nnN2TmZxnAS9IgSswaYdszrdQ_yZCdPxYs701f9FQ_CnaSGVbXkfJZhza_aDxVD8JH7O
给孩子起名字,332,92,240,1,14300000,www.yw11.com
网店名字,330,69,261,1,18700000,http://www.baidu.com/link?url=O7oTQjDpv77odb61A-Tl4AC7OEGGVf18oWkLNrBNjMAIlcpn15JsALXtwDpZjgLBlfm-N3q25iVB_rH5ln_vy_
qq群名称,329,71,258,1,4570000,http://www.baidu.com/link?url=exJYsuciyCBdG0w95k5VEvGntuh0VnA1RNbAFM34xF1vHgvj46b5niE0iTXI6Bq0ikuEjXfbvD_VLC5QbBUrQPSnxjmiQE8a43XDSTYBT2i
根据中文名取英文名,328,79,249,1,6530000,http://www.baidu.com/link?url=TrNxAUp9psd9uxIk86s-BAnDa8WCYq-4fPhTHOGU1j6FbO3JnbGXBaQxJUxF8UQRVKp5HudJqOTZdNbVJQ1hOOGXkAD8KfLvHWNaDZu99xq
测试你的另一半的名字,328,81,247,1,342000,http://www.baidu.com/link?url=fxOGfxzv8v-bOtlsvKVr_wBKaFt1rI2vNes9G2KBYqZ9iMJ9RfJrz2QoqJPvJru9hi-p7xNGg9qTLvCfdY6AGa
公会名字大全,323,54,269,1,1340000,http://www.baidu.com/link?url=gQgvvZ85n6GobR31dlsb__RRHIkjCOi-Tx4cIumKjS-uNXYaHTsbDv3mQWkzxD--6jf6LwyJ-u_cEj5cVCyKmK
生辰八字测名字打分,320,82,238,1,8700000,http://www.baidu.com/link?url=ZA89zp9sGn6chB9NIipihFi8nTMBRrmR-wvMwwghb_AyQbeu8GTl6IkTiYW0vfs7
游戏家族名字,318,95,223,1,5260000,http://www.baidu.com/link?url=jiOYa2YVsGrNe5_FkTGjSbGa8BfYIYbqVBuOvQQbPDWDMv9S7l-IWvUSqWHYhdpLDmWhVNCGOi_9kdi8YA2xpK
英雄联盟名字大全霸气,317,114,203,1,1720000,http://www.baidu.com/link?url=EKNPpOSV-t5CVZOiNMScKpDDZB1nZ5llcNduM7ZSNsLEX3UIAcp32ML7Vp5SBB2RyCuwTsMXLK0Timum2tFCLa
企业起名,312,121,191,1,10100000,http://www.baidu.com/link?url=E5HRAKNNh-Sv2-PJ8fuagPVdMZXSRcsTpyGWLRaxxql48UugIcZ3eLQHfucSJ6Ss
婴儿取名字,306,88,218,1,20100000,www.yw11.com
好听的公司名字大全,304,81,223,1,9420000,http://www.baidu.com/link?url=LdADGcHWFMm03fuWID3VJvIcMixponFAbOulKwzFhWNCz5N9DJiiXdlFDVdLAX5UilJwtay0jhqdCy7QN7iWmK
男孩好听的名字,300,66,234,1,36900000,http://www.baidu.com/link?url=radS6Q1sT4IQr7oLLVqB-RBJ21UEaAMxD49OBayhbvXQ2uacguJ_l3ETDWkBwF9yFFKoBjy3scF7MHHULmMvMPi1q3IyXu6yIYY0weVavPe
取名字大全女孩,299,106,193,1,52000000,http://www.baidu.com/link?url=9G-W0KOLqc_Gal4V_c7ZMHj2TfEBhw3zEeNPvhavZ3veNFQBfAbelzGnUXoNvi5_oly5OHDKlxIlUn5xWOd5t7fAgvhky6Ji1NIGdFgUkIu
好听的群名字,298,82,216,1,9890000,http://www.baidu.com/link?url=XpAOBgjgaW5LSEQbh-SKy9Oxjj-CestHH9tupdIqCwGonCZu5nnB72K-zc43c_xclnQlxF2RNs0lh7MohgWz4jW3qLSNMDIMslVVmI5b-zG
好听的游戏名字 女孩,297,88,209,1,36800000,http://www.baidu.com/link?url=0tGceIsG_qqNofXytGiGnp-fGg8sK2VmaON8jQ4oAn1fabgwRZdbEGDx8GiPdTJGFXfWALTCCYHjyMzzdYQEgFx8WqFPAhn60bfTu2Ef12W
便利店名字,297,55,242,1,2440000,http://www.baidu.com/link?url=sW7jQ52wBJojag8C7YdLeelBL5JxaG9125JvysW7BN8EG3c09VBo-0W7Fc00clP6Vq9TgdnXJ2eCcIjbD90YJa
男孩子的名字,294,72,222,1,26000000,http://www.baidu.com/link?url=8Bp6eu0xI7gYdtuYcKbDGKOxBgeeABr067pIIbgoPqTpusdCnYNpXc77Av04PJdOyv-OrG1DGjzwX87ICrUvhviGg0V3PFsq85-1676wB8a
起个英文名,292,84,208,1,5620000,http://www.baidu.com/link?url=2eg6EchSEMJC8HW5jO1bn9Z54ql1VrBsO-C6RztX7AfdhCRnR4GldE4ZmGDeMPNVlaJgjWSRwJ96PdDk1D9xpV5zmtMdX-9hkBw0_2eKjDm
奖项名称,290,130,160,1,5180000,http://www.baidu.com/link?url=TNyCtx5Cy8tXAHDjHIVgue6vO5YvNHSxBKDYf--DypPqkEClIWVg2HVhKkFp1-01zO9lggrtYaYGTaW2zsX22N52yhJ8553XD7HFm9RRZ7W
lol网名,289,122,167,1,3370000,http://www.baidu.com/link?url=6OmZvF3Rv0mRt0QvMUEdj2ImJ8KDx4Id2ZFiqzzuHIfj8pyBYVBPCQHkiwDJ4SrzFdav0RapxMSOyENfPsxDta
宝宝起名字大全,285,193,92,1,6480000,www.yw11.com
易经起名,284,84,200,1,6080000,http://www.baidu.com/link?url=HmF7pvSUlRogLh11aYTxsZgi3Pl21KxHXEvvKuy9WXVT6DDi7LdMsKSQf0LR-LzWH7FCqAr1FercyWf5ptmxT_
好看的名字,284,92,192,1,25600000,http://www.baidu.com/link?url=lIgNIovtIbHGrejIi8b2qlSwOzr2EjoxzYQamhNQ5yKq7vDoKXhWSNriOZ4vAMmDcTkbzO4N8GutiQ4bzjg7cy-jNDniWe_3TKJtqk6vURm
取名网免费取名,283,66,217,1,97900000,www.yw11.com
怎样取名字,282,90,192,1,41400000,http://www.baidu.com/link?url=HbA0fKvS_8iYZrQKOZuZZZr-i_M7KfoP6F7ONIcxcS7R7m7ws0FUiUYFiuXBQa5Z
女孩子名字大全,280,84,196,1,10400000,http://www.baidu.com/link?url=3imvpps8sZxmL14QJ2CbRf9JlazCK8PGF1v3dXgq7nCWtGmQ2AU4-joIH_soq0oHwZRAniMTroLDOrxYANgx8FX37CKFGGfNQNbFuB_l0Ra
鞋店名字,280,66,214,1,4540000,http://www.baidu.com/link?url=IEur-ACRR3QyWhMUsVvbN2B37vldS7adpLmRy0i5TdEXA3Gpn3AXxJVfs0inHqnsJcZpg2QmT0uenq6XocQn__
快餐店名字,279,35,244,1,3380000,http://www.baidu.com/link?url=k45hCu8W9P1f12IcSKPd1SUF24SbLNYyOHXCRbOE-l1ASINaNmqQhk0PoJ-K7mWIvGOyz6ajnlY9IAd5t5W6Aq
教育机构起名,279,63,216,1,7020000,http://www.baidu.com/link?url=19xNIqMKD6aAg8etpvpAzo-24dwHNR5lMpZ_Ja40YhdcAcicY8O8Xx0cAwf1IHvaErUyDs7OsYHUnVgpqRUCZK
女名字,278,74,204,1,36400000,http://www.baidu.com/link?url=4nASAwxc664OKfiked4zyjcFDN4q9mKZi7SQ7vZzqc2WCDYpUl9-u8VAPvClr7piVYMBOFwRq0mkJnyUNzvgy0SWekX1omrghSqhcbsggrG
酒吧名字,277,77,200,1,8240000,http://www.baidu.com/link?url=CoqglYsxDCNojgw4I9dHVCIdjOOtn_OkIJtb7cenXymxy17FAg-dtjW3AJ_G0y3MkSpyomOPhFWVmectIoqMBK
火锅店名字,277,45,232,1,3620000,http://www.baidu.com/link?url=DR8QX9QhJXTGkF9nqKFupN-hZIh5pA1tiy4RYoEa0-OGl2ttuxLa7QQKBcBHJiAy3Mbet87Uia-sY3eOKcD7dK
周易起名网免费取名,277,68,209,1,2080000,http://www.baidu.com/link?url=rlNyyP4NHHZyHB2H3camKbXwutRGMHOoY0wTvs_rzyRIC_7mEe37bKs4utWfcfFi
在线起名免费取名,276,72,204,1,6850000,http://www.baidu.com/link?url=aOcVNFeznBqnWXq4EhfQcNx-0BRCwgXhfiVR8hJtY6JKzJtoGy0BPFe_rOsd6Ik9
给孩子起个好名字,276,77,199,1,16300000,http://www.baidu.com/link?url=LUQkEYiqSrYIPt4R54xh-pedDAPyVnU5zysXhigPIVK0RKzB9nyByA973yGKlC1H1Nayrf362ueEMa1dEqczbq
企业名称大全,276,69,207,1,11900000,http://www.baidu.com/link?url=enE2W9oYK8aDYQzlzHTT2PaksAnyICvxyYrP5iQ7Onq4aFpiIxSwyKOOev9b7Gajoc3JazOhM7G2FPI3l5FeqK
宝宝起名网免费取名,275,161,114,1,17600000,www.yw11.com
宝宝免费起名,274,99,175,1,7770000,www.yw11.com
孙姓男孩起名,272,75,197,1,248000,http://www.baidu.com/link?url=e97dEmEr3zFP1sYIM5f0tm5f1FOKIx0ZZV9EBP0gMMFsXAmRbBWRNJ_Hl3ARQy85IT5hQYPUXYbcdrzzz05K5_
女宝宝好听的名字,272,125,147,1,23300000,http://www.baidu.com/link?url=uiv0CKQmFEKLlEoYLVC6EPObOFgcL9LsjcDgfT3L6G69Srl5riDlo8BfClMnh6RtSaBmuRWG_DUHr6NvyuiuQa
lol名字大全带英文,270,69,201,1,4230000,http://www.baidu.com/link?url=m_40Ou9ARl_LfimC0zrhPh-0YVsdGapp5NZlTySjgh37kujUEszjUYzjModNkTTRXrgr3vNZ36JHthiBkGzNfq
洋气的名字,268,63,205,1,3620000,http://www.baidu.com/link?url=2WOEWQPYPlKWoBJM3J_4YzVAAVVjAAicW5JnDiqofbm7I7z1E3ydZ5Qq2bYGtqyvMjoeljxImv4t4ug8EyqbEdOB_Z6s4VYhYpDO5WxswhW
结拜名字,267,79,188,1,2310000,http://www.baidu.com/link?url=2ZGHhAWQ3mzxZye4f4J7CMrSE1p8QChxeF7Ou2PpUFotV3T2IPIHvsRdp-txwYC73VbPhaCukUuFBTCAeatmJb6v3_jya46Yb1--zLij5Si
婴儿取名大全,266,83,183,1,3410000,www.yw11.com
男宝宝名字大全,266,26,240,1,23800000,http://www.baidu.com/link?url=sKR3DczhooQc6J9K0PYdpFTU1MQ25WkDn6jqqos5-btF1WVebIT0aSTSt2sa8wh8QWRzKDsKtRalCBHZj9XLmk5SkT_IZUoj8x_trczmbA7
给小孩起名字,265,90,175,1,3910000,www.yw11.com
好听男孩名字,265,26,239,1,12100000,http://www.baidu.com/link?url=03vclRru6oEQF94K02k7Efcpqf8r_YMjRY2cBe_WSspatkH4vX7kXT0PJUsYZzFhJ0un57R3SjjD2GiGViBFk3lwmVVrBX16ZgF67QSHM27
起小名,264,68,196,1,1150000,http://www.baidu.com/link?url=yFQPrG6Lh0invU-9nptccUgVn_lHFuE5lJ6Z6WtWteaXuqy7JLQn8__J4Y864azA
厂名大全,261,62,199,1,16500000,http://www.baidu.com/link?url=8h1Frvt6pb6idfswcEC9sx9AXmb5xyfjxEzoIk0f3-6YPMsl-ypAT34jRZJJnvFc9Ueo0o75UVocsbFAKDloFq
改名网,261,79,182,1,9210000,www.yw11.com
好听女孩名字,260,46,214,1,17400000,http://www.baidu.com/link?url=xLDWZTdLXT1_fiZoUzNFiy-MDy3KoCs8PkjaZOufQkf1rB8tBCmXvHRqAGtAddkB5RDavmm2aozPsP3TjFOjfztWudBBhaDSa8HRr1fAVZC
cf战队名字,260,49,211,1,2050000,http://www.baidu.com/link?url=TX7vYWGL7QCg5K8cyfYVfuTJCOHwb0LbuqfzQu4OkBhUnasGEwneCWXKQuRNgcYVNqKOJyCqf71vnM-oBsa29q
如何起名字,260,96,164,1,21500000,http://www.baidu.com/link?url=iWh5ZhbkMmDGJrzzFSQscxtlJ56OYvXhuztiHyaubpwYMB75afKtH6aJQovsrTUq
工会名字,259,76,183,1,4460000,http://www.baidu.com/link?url=Y_T5xr99pZlMyEtSxQWv_0t64ee0rAfPEib10WlAqdcyRd1uXHOUA_xee3wQKABxTK431wghS8L8jdymczjx9K
咖啡店名字,257,63,194,1,2410000,http://www.baidu.com/link?url=tx7XStzbv684dQYnvxNAjbJjiTlTWjH4m6amZDhF4yCF4U7tFcYXKlwFHgDkLr_mOJFZraFt0AUYW4DBA36E6q
好听的女生英文名字,256,44,212,1,10000000,http://www.baidu.com/link?url=AHd-kh8_PtWP0rCcuaMwIT16O2pdX7IwL86Ihtp8tbjLN8KfMAJqKPnOPEXV_eUGpMW8L4c8xfviyVNSqJ1HGss5Qb2Welm___INSderg_W
查名字好不好,256,0,256,1,10600000,http://www.baidu.com/link?url=FoXjeAhtN7hv_n_J7D9l6ZKj6ZLvVMPFQx6MbLcocN9Lo9-lnormapkLL5DJpsRS7Y8K53GZIVTbYhyoCirASa
服装店名,256,56,200,1,2290000,http://www.baidu.com/link?url=ID37Gtl6r4wYmrB6HKQ8uT4iXMvNFHZ7eT_GyJF-VER8_YSMka4rPDblq2Og_Y1Q77fWcgjGVkWAOiAju2ClMq
传奇名字大全,254,65,189,1,2410000,http://www.baidu.com/link?url=xDeK_IxioabvkLRrQrrt70XLTr1cqndEY6dwvaGz7ERz36o96Y0fng_3ORs0orChy7rJub6eIftz4JDG9D7aXK
双胞胎起名,253,104,149,1,3610000,http://www.baidu.com/link?url=UPKd8Q0Y0itDItJJYpva9D8f3AY8NVV9fe1CSS9TW0f7UnwrwnFd2uRhHcFzVe5X_eCMhKTdRbM5EZ-Aof2co_
孙姓女孩起名,250,67,183,1,310000,http://www.baidu.com/link?url=qPSUnGFMiA41remvOV3MqabPl21PsmLMFM930J3n5CG27H8qsws3eerzl3CiymNxhG7Azp2pJGGigx2fEhCa4a
女性名字,250,108,142,1,34900000,http://www.baidu.com/link?url=BgnOLi2JPMP7W3rV9Ud5_xhODsEaqmbDojr-VT2jnqcLK_XNbAdYwpeEQ0QE6VuID7v1R4A7ATcvN6fuFGDre7txJpHZI7M1aP92XLTswNq
梦见一群狗,250,34,216,1,233000,http://www.baidu.com/link?url=cENf37S75QHorRyrowdBvtEWIJ_fk41vqTb7JM-3DdvZcUUFnfJJW3tj4EVeLioh6z2MhdEvSTgexnf_adtHSq
男孩起名字大全,250,78,172,1,23900000,http://www.baidu.com/link?url=3eViJaFOmGiIlgrmrsM03j65nEMCq7fCp-wJLIaf-cM6Uklc9kVPCAD4BLQEaxLzbshSHZ6x0ZCFrCYwadRsilO2FOmHURZhAo3cCXdYmFi
取名大师,248,25,223,1,11500000,http://www.baidu.com/link?url=e4XpypwEjRCvuQupAvwKBSyUnjBh9etrxavGEB3Nf79gJsahbB0At_E24jh7wJs9
免费起名大全,247,86,161,1,9770000,www.yw11.com
好听的名字 女孩,246,154,92,1,13500000,http://www.baidu.com/link?url=w1PGiRtIsH6vaWJmm7PWORjErtHhhu-TKWVmltGJsLGBjB5ok5w5g6dtlKwGiR5Qy05JmjN05dZJ16XA4yEpAVPMpNNEZYBX-EnJ4neCh4C
男装店名,244,70,174,1,1930000,http://www.baidu.com/link?url=gD2spR6m-Pp8lVr-jnTOuU_hazylLCppZw1hutUdUYydNoJ5e33zxkqkhhKK9K64TA5rqPJawJ-UACwb8cUkUK
英雄联盟英文名字,243,86,157,1,756000,http://www.baidu.com/link?url=MFsIIpOC0zsMo6N0eNZHP_TfAJCw7Jm-gfqU0Rm2SolR3tGyLtseg5d8Bu_hTsC_B1tFyKiZ61Z6BFaXyGpXoK
徐姓女孩起名,242,53,189,1,172000,http://www.baidu.com/link?url=oSkp0FZSmSUXlPFmQyhPVX4x3kUDiO4gijMbGDlvySu2FGljiWsiLGzMTD5KEDO-xGBXTXvFAqLMekqS3t1h2_
绰号大全,242,56,186,1,2410000,http://www.baidu.com/link?url=PqgGRttCXO0oG9H2aK7pIuwxlG9lL5XmsLI_efqXPEsYQL2RoK15YJV3shJMsde_-5W72I9435ScAHWQd4Ckxq
有含义的名字,240,68,172,1,3930000,http://www.baidu.com/link?url=P0irhd6TGpVMbQYoy9TSPpLb_u-DknnzxMnPgBHKZk-3mTiJx-OjIiYnC2JNcjlIffAY5tBwPwXdpiLEwj-C_78gHszmGuh90LnU04NwDx3
炫舞名字女生,239,73,166,1,3270000,http://www.baidu.com/link?url=Yhv_vLMAR_Y4VD9JDer74BAN4GdquqQ2awSbByjLQQSu0sbqNUGOiyR7QNQX7GsMXuKelGJm_vS5GQqsxfigKq
联盟名字,238,71,167,1,9970000,http://www.baidu.com/link?url=dFomsDVR79jsgPRrJ3W8UtLwtjeJBlO97IUivq9ZubKsSI6xUktzmxbVbbolw2eoQ3T58tpn0u4WmGtvn4M-VzR7Rwp_hgjRavUsS1-A4mO
女装店名大全,237,52,185,1,307000,http://www.baidu.com/link?url=YYoOLSXJXaBozp1Dc8CnGP9OQLA4Q260rmRjSGqFJkDzpmKO_GNTrfnIxxCPsWkFBd-oQhFt1Yttt4_4BMaRE_
好听的宝宝名字,237,54,183,1,29300000,http://www.baidu.com/link?url=iu20SHR534Jk0AFMAnosskHiAHuDvakAuWttiZLc8lJJDKOSFwQYd00uadNCkqDoRGA_Jp9K3Yqd-jmIl-GUtEEM0clhr3skva1S90bfAHS
帮会名字,236,71,165,1,2950000,http://www.baidu.com/link?url=XnnoAtbx6FH8OZjXF21VFV003eg4qShj-5S3qB9D_HisuM0g-4Uuj2iPT-15dq-yVRlnkfu5CMkFl_HFB-KMV_
给狗狗起名字大全,236,106,130,1,7470000,http://www.baidu.com/link?url=sF7Dt1F3aMeM7dlluUl0SnJ0oVXg7szNW68n_IRRLjtKt-YFsKP3G7mjjBxLoqu9BR-X2FIqqG1KQwEdCCZjra
餐厅名字,235,76,159,1,11500000,http://www.baidu.com/link?url=keQh6NOzMNX6VyLUUey_F4jCWUMbmR3wBR44rGQhwox1pDJhgIIZzm6JbPZc3sQwc2E5TU3UefX3y5c7cFWI0a
讨论组名字,234,55,179,1,1490000,http://www.baidu.com/link?url=4JoHd4MuvOUc_auNAuahBDXl8jKhf35KhZMZ1tOMuRi8hs2TXvU8jBOXE31XQrnpn1nSQvgw1LEnDezHalDb2_
给宝宝取名,234,72,162,1,7080000,www.yw11.com
好听的家族名字,232,69,163,1,2730000,http://www.baidu.com/link?url=wQ9bEMNw87Ek2t6STVcwCpmudPxPLgwO6xr12_TojrT2S5xN1jST4BMnrP-IsJZkRK7JiQGfJaJL3ej_gXiQga
给男宝宝起名字,231,87,144,1,2400000,http://www.baidu.com/link?url=uxd9cgW5wC-2bdaSRvYFvLUoKwfZzKecBBRVHuh1m7mjaGu_mcHAYaTc_jPzHtVUg80krjqN2QNiBKxVNilEU5OzPNgoAv-x1ftYq9woSZC
狗狗取名,231,70,161,1,2680000,http://www.baidu.com/link?url=3N5gTSqhkS07Twm2wrJdxV0C4l-QLQa0HcZYtCA-OHmkxSrOL_KVrc98jYuW2YP4jnQMg1Vc9uHU7jJXo3QmIa
起名字大全女孩,230,66,164,1,41100000,http://www.baidu.com/link?url=VdHCNap6XMhDhzOFOPRqonaa0DAOTNHAv05DtXiPcuK0Eix1gbp8srgJdDm8zegCvAGdIbg77yiEZDy7sRXesh3t93t6-zAK0CqMBQ-6ms3
公司取名字,230,62,168,1,37200000,http://www.baidu.com/link?url=cwzHIjwb9s4X5QvmV1Omf694dWreOZ3JStXPm51ZaPtunypdXj7bPDRxOjySkNNd
男孩取名字大全,229,67,162,1,50600000,http://www.baidu.com/link?url=rvyW-ySBvmJFMzlu6BM4EHVajCd47ORhh-mhrsVOdtlqFCEbb6eSpLra_gqkRSlKDT9hQISN1Q0xEwsiG1NYtKD4ObFirO_EOdy9cyAbksS
给女儿取名字,229,0,229,1,2550000,http://www.baidu.com/link?url=3KMLJwGbHn5cN9ygpAhdZQSTeRZEebK4fqV5qzk4eGoA6nsNT0Dl9uVnyrVtgXPLeiOW4Un6EGEVVr_Ps1UpaV5AzLKl14ZuxbRn23Zb77_
英文游戏名字大全,228,81,147,1,5070000,http://www.baidu.com/link?url=ihWr5lhvPtiaiimHyM7j6-oDoZ2noSWWP5tLQr4lVLxq_4632yZeCkt-ygAofkyWiX3yP5YTiHrBwCtOXO5nMXWgSuIBKSnfWNyICpcfcSe
给狗起名字,227,35,192,1,1230000,http://www.baidu.com/link?url=gAaeJI37BZOpMynun3P0yIcK99V9P_sgtETp_Qbz5yh3ylQuHqMPNMSEblRPxvLus3ZY0dADHUvU6D_UWaaKfq
如何给孩子取名字,226,84,142,1,14100000,www.yw11.com
专业起名网站,226,77,149,1,5580000,www.yw11.com
好听的团队名字,226,63,163,1,4160000,http://www.baidu.com/link?url=XdPKc8Wr4xZ9t1B0fI2Pq-elS-cz18H4HX0IlPeTjjFnILV7pAZ9GQokRga8JLOpN6FNY98wTq2gHNplkpaKAK
lol名字大全霸气,225,87,138,1,5430000,http://www.baidu.com/link?url=6MbeeGE-1H3r6uRV6iuvjwSpYpq9S0KF1pWSXjuPfyyjor53nkjs2ZVYvh3qQ4-E4zOMDwnctUoR4RauAFrG0_
商标起名,223,101,122,1,5420000,http://www.baidu.com/link?url=arzb1n_tm_BVhVFElm0MW4bEV9LXB7VfZ9McUd8TNEn0C0z0185oaNGQVwDjHhPKw8kGBFNZT-Z5_7HWlU9wXK
好听的女孩英文名字,223,72,151,1,7900000,http://www.baidu.com/link?url=ZV3Y_fSmHieiouEeN3Ek4N5N8XLLBW-fQW4f-fgUbYzyFxjcYqiEGnKfbtxVzmz26IhgKiXWn9eFhIhaEYGNq5Tt46FEuhYS3dJ4amNmv-G
男宝宝起名大全,223,53,170,1,6200000,http://www.baidu.com/link?url=zuGig9bpBQbtT98tbJ1VxY0cmfq2gcZEovzJ186DVYIL28s9Zc0gSBSQ3Q0Z9XBotHxFKuxWDC-b2yEOA_tDWrBRI8EKTMJy6vbwx_xGZb_
军团名字,222,73,149,1,4310000,http://www.baidu.com/link?url=MycR-dkLGIW3w_ewCHox0zw8sAYveAIx5AVwxxUm_aJIc5iu5KadlpBCHg61_K-ZfZXoNkJQkUsIXt1tesk55K
男名字,222,34,188,1,37500000,http://www.baidu.com/link?url=bZilXluDaqWdUa5OahIZzRSbsTBZPX08HpyTzTHSo8PVQpUTgNMJWBkJK2hhqqPvsbBL_RzgPvBD8dLdKoZb6myGaVWhuvhqCAI0MLhlts_
个性群名,220,62,158,1,2550000,http://www.baidu.com/link?url=v2TM0NVTm3JhivMUILYYKcVrOkhACZKWlVN8kFmPSO2TAGXuZ5pp9y2OnlyEjp5yd-KY9tAiE41R303GFHPJNK
脚心有痣,220,54,166,1,301000,http://www.baidu.com/link?url=9S6TSUAfp9uzJgbZBWs51mstBZvCk9uLtJoUtkxNHYarADfYlBcrt5Yd5Pt0BXgyyI-uve-TTeY13Nxk9YPW6HvjyvgCdM8Z5INb8FRkKDu
田姓男孩起名,217,61,156,1,58900,http://www.baidu.com/link?url=3P9Z_VVUV8C8gg7nBgNzJM6iYWv7EbXuTkusZ1maRg8WS167c6S52-GGrfdh3BMRvpuKasMKZmyDVVKpkIUZErLMQ780jlWCvWn6KoqY6su
有意义的名字,216,67,149,1,29300000,http://www.baidu.com/link?url=VxVHjS-sS3BCf6_vWVDKOLyYtq6CWcl_KLyOdQ95Fnfmr5X8hUBhX3vcrWvmWl7Q48QjHmb4I-Dc2X4ajBvf3YEvCnhAWHVDfy_FLDdtlSi
空间相册名称,216,25,191,1,2130000,http://www.baidu.com/link?url=5bTUalsxcc7Xw6JKNGsuY8FMPutlcJVDa8ntf2c-KXFNjtNtxHFmxw4Cyeu1eS0wLBAWlt4l7T2M7wNG-UAGY-uFw2Y1KN4Hq1vXTPVWKki
女生英语名字,215,63,152,1,5350000,http://www.baidu.com/link?url=THOGUSnPc-XFS2GSnEzckeAl7KiGlsyZiz_-0H6PDkUeARAgo_KEcbyJe2IchRhZPmZAD9mTnkzgK_zKmSy6fDDyeXYezFOIFFHEZkk615_
男宝宝的名字,215,54,161,1,25400000,http://www.baidu.com/link?url=1imofbsJPPHu_w1nz-i1rdHOwuafyzx-Fggi5lezMdJ7RgM9HHXTRhSGd4Ngi5xDZxK8RMSo-tb_1dV8C4toZEiafdIeisuY7dtHKF-K6Xi
免费在线取名,213,73,140,1,3390000,http://www.baidu.com/link?url=vy2lJGXH19tm6jUN0COZQk5Mh0UWXSGHb-CIPbKc1BuiwOoUNMLPw2QffLTbdcjZ
八字起名网免费取名,213,77,136,1,4240000,www.yw11.com
宝宝姓名大全,213,25,188,1,7310000,www.yw11.com
好的英文名,212,72,140,1,5670000,http://www.baidu.com/link?url=YkdCgd7_oWGwGg_JqGld5kGt3tQ448XefGM5SkjrJ8kgqUkjM91XRvLpK_ykL47GiT2ANYfozINjRbi_U8bBHao_8huyNbccQPZwi8ENM03
贸易公司起名,212,87,125,1,467000,http://www.baidu.com/link?url=q3kdFe-yNnqVm6T7eSdwE4JSqJKfTMfH-c2InEkVvntBL2Jzmht1q5sgofloc0PuI79a9Ff0BgwZSECHuhaN9a
起名字 男孩,211,76,135,1,13000000,http://www.baidu.com/link?url=EzqQas_2zvyn2Ob6nQ0SP5X-gc-C9Bi6-3CvEjmwGGw8HRQUFFSyC7RLTZeArHq5Q5NJO6-HxV9WWn33x0DOWy-59VeBPnvToowz2B4__RK
洋气的女孩名字,210,35,175,1,62200000,http://www.baidu.com/link?url=OVjdlDTFHDMR-SN0d2rFY77CdFO6DRsoAdU1pLfY4XrjJqn3BD4UkWsgY2jJ7C7FsbR8p0pNUIO2zLL6KbqP60ZhBaDVwtteABX0n8k1JKy
好的名字,210,69,141,1,20700000,http://www.baidu.com/link?url=JnEvQw4ky4Sjjjx1rHoX2rg5JYY9KzJv8pM6vLmQ4iuNcXsS4SPk4dz9W7CO7EzFuwHbnejqHI2uKtuDJPzmtIuhOjTnT5Qy6p3wCF4GD0u
企业名字,208,83,125,1,47300000,http://www.baidu.com/link?url=VQxoc07osJAUQimYnQ8pMnp-0fay5QS2LkJrNGqKjCA94Qg-2IJ0qgXcG99DNv7f
传奇名字,208,130,78,1,7110000,http://www.baidu.com/link?url=0-vxEtcA__BeP9IVyDQvGxEAK2URLvodvERVX8PG4hJf1X-PRL5W-y2zXJ5pFIUckouNv6Vun0EyogtMvazteq
外号大全,208,82,126,1,2380000,http://www.baidu.com/link?url=FNwjO23tUMyr68njOXbBGQunsqoOCqyd1k2zbzVVzUY-mx2nf4aHObZHFv4O_KcTQFXRpAAsMH2yvX8C06ezZK
给宝宝起名,208,94,114,1,9730000,www.yw11.com
如何取名,208,100,108,1,10000000,http://www.baidu.com/link?url=bmtoLEK9V3VsU5WX8XWGNX1-2MGTQ5X3av3V_tyXiY9mpW4uhx_XTjRH13mdp_0tmuQERJRgM9adbgSm8T5luK
于姓男孩起名,208,45,163,1,25300000,http://www.baidu.com/link?url=J6GaWRd_J6f9M-jFzpwVIhwshxBKqUiFpT4nX9oNJytZOMuTbaQFcnhCxWNPKg0KzOGOufI6mQHej4aLmYJOoF510y1LjyNfp75PJTKRfOG
好听的英语名字,207,69,138,1,38000000,http://www.baidu.com/link?url=_xW8H_KzE7c1QyrUbui8IWL3ygUmAnl3FOTS9kJAiCyGoSdVJQAJTzpDNSVmy9KRTHwGK52Uv7q3G6DL3XoJSZsK2cjiuKT5XagJrBoStIy
女孩姓名大全,206,63,143,1,3390000,http://www.baidu.com/link?url=uMkwOzGDsNrIpW9IuPVxjss8-OVdkqWyCdCC1EMI50uS14fWQ054LMdzsmhIKQSCgOlHyuvXotUliEFgjX0vo4WDNcQfYxmXfGGZwm9I8tW
起英文名字,206,65,141,1,13300000,http://www.baidu.com/link?url=HyW-NM565UTz4eEEos3By5vXXenwsMT_fBe1FVlHV0JZ5yMgQNPi3U4_9qz9om5iLHnIvVbMd0ruZ8eOO2rNmYhRw2FECwvnuZu-_9gCWI7
在线取英文名网站,205,52,153,1,192000,http://www.baidu.com/link?url=MFxjcGzjRSbgB7r8mjzIuNrazKuUpbBx0u69xhiJ7FsxGFEAO_OENuZLejvOrvrBHqDWGD95zGZIQxcqQbeZKiCglnjH8I6mGtHIq8kfafK
好听的英文名字男,205,121,84,1,9040000,http://www.baidu.com/link?url=AJhXP3q0FLy7qdgGZkbQYEMfL1IPYOOymZSyulT17EzofyBRca5VExfaejDeeFok5mX8E3mUMG6yZTKdAEV4fI0KR6ErnyZL61YCdVire0q
宝宝名字测试,205,85,120,1,4460000,www.yw11.com
商贸公司起名,205,120,85,1,662000,http://www.baidu.com/link?url=gijLj9mpwibIxJpIg8m654maGBon-0kEDS6NIGvNmc2jBJ6n-y5hunj7OF9OxHy1byGjpoJPaBRTExID_y0c1a
好听的乳名,204,52,152,1,1280000,http://www.baidu.com/link?url=Fd0Ah6ttadENBMWWpDLWz7nPevzDgPkqJsAW2TAxOxl-_awL80OG_ILgZl31O-0gcpjwlHDYDTLvZBG0Yuyk7K
英文姓名,203,105,98,1,19500000,http://www.baidu.com/link?url=JGWT85ugXKCx7FlyRcXaDahOcj-2L_s710l1MYKCAFtOtw3qu9m6jjJuSaB0GHswlfvrnXyWQR3NRO6effiovB6v8CClqe1XOFh78I4MjVW
lol英文名字,203,85,118,1,532000,http://www.baidu.com/link?url=fd5NEtuiN2Riv7LBBv01gsum8ed0CY5c2d1RbxjdQUcovQtkuR10MAFW4fg7g_FyeLYJ523ew9nYHGxTXMjNP_
宝宝乳名大全,203,57,146,1,1480000,http://www.baidu.com/link?url=wh0yv50MloZ8bFAnFOrGAcWhC0m0hgmXLzWZyhv2mt9h8SmKeI3X-toFU4DfgilN6zFLYmm3P1sEKCLUwXpLrblrN8q5s6-0wh7qYMAIs57
张姓起名,202,44,158,1,2240000,http://www.baidu.com/link?url=2n2Ciilq8bLWjdI85Yo5ZDb4svRfEClLYlv3mHtHhJ5L4aSN0kA0l08TkmzzhHa0tZkwmVL3cjl8n_tUDYhLhK
女孩子取名字大全,201,73,128,1,20200000,http://www.baidu.com/link?url=WPhd4hnT2ZrP3zdH5UAok55OtzUlf5FJDkHWv117cVl3vVeF3fMixSHLHnwK5bCl4ENVjmlDfGfSMqaMB0vN9ERCfbdenlV01Q1ZanHrUQq
网络公司起名,201,65,136,1,4320000,http://www.baidu.com/link?url=1SdzZX5oeDIby0kqY6i_hev4198aK8E51mCWR87wjs1LATQCNkpk7LJmUwafbqpwWzcFQgSUhHjHJz5y0oTOBq
生辰八字测名字,201,71,130,1,7320000,http://www.baidu.com/link?url=tmoNxyUw2LW6I-4P6RW5pG0Y8mSLVBtzxndR6nfJ0YbEARMcLF4El0nYdbuMp33A
女性英文名字大全,201,8,193,1,1480000,http://www.baidu.com/link?url=hW8MmZ7B-V9702mABqT_H3YN8ybo6fRKfYygaF42hd2PuIDNWBOcxvdu3FWzzm_IurhyRbSMiKw-XRhlO_Tsr-HfwGo_pVEmnNR3vnk-tva
服装店名大全,201,55,146,1,489000,http://www.baidu.com/link?url=07_KQHmLK7LkcE7ZksZ1qDkwkdn08dq0Gm0qdB3bR78uVP8ymTQ3TJEff-SJbKyYm3SAA4KdJtNnDnuFxvyAVK
起名网站,200,106,94,1,18800000,www.yw11.com
游戏公会名字,199,75,124,1,3980000,http://www.baidu.com/link?url=O86CJXIaq1bJ2pUy3P-2JuIn6EtvSXpNtE0_dZc7_sOPg1lubwW-cZf1oYS6DJsYxIHV8ZSEbL3R5hlBblpMDK
lol游戏名字,197,57,140,1,2830000,http://www.baidu.com/link?url=ma9AbIP8F0bI1jX0N3BIbsT9Ttf1uibjJdJDCiWW-RTAH8dmw51xBQZCGiBsHuf8rTEeUW4Us5QIJW6zS0JwMK
婚庆公司名字,196,67,129,1,2340000,http://www.baidu.com/link?url=Zq08oXqnCx_DY9Fw2ixuZpZgC2tGzey8JfZfRuyLIKcwxf8Up174YpcRHpb30_VBx8JlPIM3t_F-dOZMDod3Ma
食品公司起名,196,69,127,1,514000,http://www.baidu.com/link?url=pI5jYZO4dv-4DSzq2FdZqtUJriQxcknYYsTIu0xwbU3lab0mI0yLz1tdOjj-feTtGcgLRB6sX2i8v9x5fJieyK
宝宝取名网,195,107,88,1,5340000,www.yw11.com
好听的队名,194,64,130,1,169000,http://www.baidu.com/link?url=NKwBgYZhresxh_H7Vr7wjK9w8MA6bFgGxmHjSJS75pL-O1-oJNTwuDbfzZBZnW1XVDu0JxJ93OLfQptr2S0kkYkxhaStd2mUiwwL-xRDDPFuVnYeBrVIoEyTA9aG3B1s
免费生辰八字起名,194,62,132,1,6260000,http://www.baidu.com/link?url=u79rJ0Z_YmnXGpo2dFwTX9HqSTo1QDoTo2UdlvMbICHDlGq4Aihugty9ahbGOZtV
游戏英文名字大全,194,45,149,1,33300000,http://www.baidu.com/link?url=F05Y2vJnS7P2FVtTuBVG8KJvUd9gsSWAkxCJxbvNq5ufprnmFFy6d71O7ypa42nLKjb4pcRN_HUxbpI_CtZj_TrHTfal-Dw5FDD_Zq0eObi
好听的外号,193,52,141,1,2480000,http://www.baidu.com/link?url=vsN9u4WOta3WedFiBCZX1LSe9oLjuLtqI7A_akEh34SchRb3-qwvZzFbCETGxfL1lmpkjvQYvlZOuWdHlbiuP_
游戏取名,193,85,108,1,12100000,http://www.baidu.com/link?url=Dm8l9wrJiHyYAcU0jbyYvP4BjLtx5jrsc8GS6f1XMP5uIH4oWlYrkcVSpYa8_B8e
英文起名,193,97,96,1,12700000,http://www.baidu.com/link?url=DGCuh5J8GYuIFrF_6cfGMaFMMFSK5qFWs_4QmYlhGyn3bDvK_8pzm6xZkRGRut6SA-Yy-GshtQ1Ez18Of8rgWkWo-yHXUaYNiX1JDoz8SdW
宋姓男孩起名,192,53,139,1,105000,http://www.baidu.com/link?url=WI6vXvknPP7Q29Q-k5rYof4iX3k8c_rvGrUgwh9p2LmcdNtYHh-aEoj7CbyOYrievjai2wFXSrv9C2Afv1DMWK
如何起名,192,98,94,1,11100000,http://www.baidu.com/link?url=eNAJmJeVgvQzS2k-LFd8PRvVmoUfpYiD8zDZVUJad1UOy_N601WuCu3d2kwftT9w66lNdCNb-tEsZrtvCQHhla
好听的女孩子名字,191,62,129,1,38300000,http://www.baidu.com/link?url=KRXfHx1xL3cCz4SvITZtk_attJbSoTj-vHOxULtL4q05nKacFOfxfJLqp9p1DekJdDj9_-38GZJWrXvZT8gQSX0I85aTVQ0hhxDRv1tLpnm
好听的帮派名字,191,66,125,1,949000,http://www.baidu.com/link?url=ZM6_qVqIErKxKQfaNv3yLzA8Wqfskc4wwR6Jt2YLURYPIUgsU17i--eoXMYLQ995gWnnNmq9pfljqTYOH2DX8q
cf战队名字大全,191,102,89,1,3760000,http://www.baidu.com/link?url=LlPQtt2-9bMJ5QRVSG2o_gCMecvZR5LqEep2wNTuXEuZKkPB_ncR7Salu5shEQQUlIKa3bepDTErHvpojtljsa
给小孩取名,190,95,95,1,5250000,www.yw11.com
武侠名字,190,87,103,1,5740000,http://www.baidu.com/link?url=N8NWLmt3PDASyukS70Kp5XnxjlQsdVtVsU1L326HiXDXlxjnGAdunZOaO30bJIhmh9lFAlUfm3R4zU0I9-uEggkdXFp-6zwrFIvtCgRFmI7
舞团名字,189,73,116,1,2570000,http://www.baidu.com/link?url=v2ZXwWnvrlx6DoYzTxBIs3hKADOZiu2yggB5wuHcrRViwUmsVGKwfbQEbRtzlLUFqlOMZt6FZWbRss4vFIVz-_CaaRnZiN5u4WMoTytJ09_
舞团名字大全,188,43,145,1,919000,http://www.baidu.com/link?url=4VNBWemj_ktO7298LXwWhmoHncM65jfNq8QCJiJYpkZUcfr81nBGaWYswncDQGFj4ST5llWLrwaLwAMuK_eeue7cvmbOHEJx5BbZwrGEag3
企业名字大全,188,53,135,1,36100000,http://www.baidu.com/link?url=8gn34V9ZMLFj8LEK4DS-F_Gm-E0aNlC8chPsAtMeVw5W-vuLFgf3dIP6OrgtNPFb7J4D2Mlt29Czq2OOy4dAx_
品牌起名,188,90,98,1,9530000,http://www.baidu.com/link?url=O5Wi6sDrYSXmLiNCR0bTdlMkJA8MZFEX6bKTlgNp9wdsRwL8_95amhKJ7HChk_e8cwEnCK6-AaaBnkemhBDRy_
免费取名字大全,187,66,121,1,54500000,http://www.baidu.com/link?url=SpQNVbwf37qLDlDdC5HN9jhMl6E6FW_2QaycYHcVbJx0mZdobOXFqVMDKilQVWZW
酒吧名字大全,187,43,144,1,2270000,http://www.baidu.com/link?url=r7hnIAYDgBG8OsChLubntnrdrcsmCrGcAeIHjtGre45XytzxNYE-xvxyficS6nQ2FoGZEwWreKBVTcJ0NZ4sqq
饭店起名,186,66,120,1,4380000,http://www.baidu.com/link?url=wr_e7ZeK8S2QUQIWQpQYcNbfvRW7zM3aVNmXke5scjsoyoRohZcEq97TqcYL8tSz3qf58vIwtH70Zh_5GNRwBK
公司取名网,186,60,126,1,2710000,http://www.baidu.com/link?url=3P3FcPVM-N4Y-QWipCJ-cMEWy0v9t11JXYruZNWsSWonD-b4bM_vukuF0_cliTi1
女孩起名字大全,186,76,110,1,38300000,http://www.baidu.com/link?url=uxO5X-K3KzAboSsAoNJU-ys3Csm27D7akpL_PeQCpl7juEIx8GCr1y4-dGuBOqoL48li7vy6NoVzlGt-7A3kq5v-bO2CPS3j6MaTdUyLr8K
女生英文名字大全,184,47,137,1,996000,http://www.baidu.com/link?url=fsbbPtY4WDIJ_q-2ut3PKHFaK6mVyBPRW08lYzZPaPpzHhnnJKl2ByXLWZYgnHVgpEaLO0sCZgY8iy6eAtUvFyUqqTX8Q0ItSIL2DscZCeq
小女孩名字,183,44,139,1,18300000,http://www.baidu.com/link?url=Z7yYRPhA1VRXPCDJSC7lv90gNx2wHPEYVZCZvXbxgCoT-PvGVocUY2ebFPSmzJDsXXdnkBkQpNXMabna7rZojld6wE7zem9IZ7jw7OQYpDa
给孩子取名,183,69,114,1,9190000,www.yw11.com
男孩姓名大全,183,61,122,1,6570000,http://www.baidu.com/link?url=nc9rcCN9VT3Np91p1KIW4i8fefOo-V2-938XSs-gPx7yUnDED1Q4Pepkh-DecYqFG8ImXdAxu009iKZAQqbI8lZV5yXsjvc5kxEbhmIfLZS
梦见鸡下蛋,182,9,173,1,72400,http://www.baidu.com/link?url=bVOcxjS1SJBBA0jmfNarPvg8zWpw0MSAJQEq9B4EpYtlxEWOa-JCBPlS2WiBV8W9S6r8iervXqVeZX-2Gaca7a
qq群等级头衔,181,74,107,1,671000,http://www.baidu.com/link?url=IQDcbAqhceywZXRbrpxeiOnBK_oZlILsttJhqbiyyez5xXLRvvipfVsbykaudO138sc5nTCqD-EMTy8_0OLsM_URiXdUApUHwdDDEt2wSAG
李姓起名,180,51,129,1,2760000,http://www.baidu.com/link?url=DrTK78TdL0wWhiwZU9qfjc2RnObmE9BPHYC1xZZQDaTFxAhLKP2e1rWkhqIuvmfMugf4w7hg-CmEm5LVXPN_q_
好听的公会名字,180,69,111,1,1180000,http://www.baidu.com/link?url=vaCECmf_7PTR0w8lLouUWL36opmX6hTnoedH32mJn3bKG8dN9DNFzNt2jwdof7l_ESda4bhP9e55Q4muGm4puq
游戏起名,180,73,107,1,12600000,http://www.baidu.com/link?url=16uxhTMTL42aDAeA_u8CZc2vQAQDILNhAtdzRnyH-7IbH8JYDOprMvRh_sXEoMKI
游戏家族名字大全,178,17,161,1,11900000,http://www.baidu.com/link?url=4KnSFAMZ8SkGM__LMj3hFxs6fuPXxZJ7gCwFwFruYOLxQKmPYgKoOwbzNrbtsvOYqYhzWQNc0L1vW3ShmrkUCq
起名子,178,60,118,1,30700000,www.yw11.com
杜姓女孩起名,177,35,142,1,106000,http://www.baidu.com/link?url=ewd2s9hXVaVWMBn59BU4SVwtUFCvqRReA0i50258W20SE8nkF4USYviqtMJEQd2Oe-0_lLzJZ2KDq1ZJTURDUCsDnuTEgv6tRWIetoOMm97
好听的qq群名字,177,35,142,1,1900000,http://www.baidu.com/link?url=YW1f0XP1VRcOq8YtwsIv-ezUGGfzgYeEWjRXQchST9w0MuPEi31lk3A6gvr2sNSr1E93biNrRAoFyHKhBhSsgnZ0ry2TWfWlDYlXkUZHuMm
怎样起名字,177,84,93,1,24400000,http://www.baidu.com/link?url=-bQb1BaZp0UD_JDKt9uBSQFsjShabWqOILTFYF4bkhpr_iz1WMGzXocB6EaxBrLv
于姓女孩起名,177,44,133,1,1090000,http://www.baidu.com/link?url=idcwXotn5GXg9nh6U0f_yMxReUREvelAKSiq68735nzZZqQISYhL97J4SeCxTlNL-DE3n4bVXCZXfBa0ny7dc0RXd9n00McAUMlwDG_XQ6y
给女孩起名字,176,57,119,1,15000000,http://www.baidu.com/link?url=DhMpLjv6J3t2eaS5FS54yW9SKBCtEa2k7uXwXWa1_7LwIQSoOs0tKEKn5mXONr7Guf1SGb53DDPuXGwuf8oBgSaYk7EJiR5Sn5aJNnaQSjK
宝宝在线起名,176,90,86,1,5860000,www.yw11.com
给小孩起名,176,72,104,1,4050000,http://www.baidu.com/link?url=plpbP5jN8p7L1jTcYOXahIFHuoaShBtDT-Fz58SLCU7lbl_IkxcS1yescoqAy45b
网名字大全,176,44,132,1,16200000,http://www.baidu.com/link?url=awU0YqT-K_XHFGZatqvH08z28aJhwO1NFDFGg2EilX25SoJDq1gbs-pGs46Ae06h
魔兽世界名字,176,99,77,1,4520000,http://www.baidu.com/link?url=ZhZfIhwpCdoetxJowIouAhq2EJxRTA8F3MsFD_5_6Ep5tpKNLLfg720JQQTZwsKidtEhiZnP1w0E8BfX1Zekkq
团队名字大全,176,52,124,1,32200000,http://www.baidu.com/link?url=7nAdRGLisaA0Yoni1If1vpVNEbiq7OAsrcTk8lyVH8poJAPszPCHaQnj-NT9E1OHDOc4ft_S_ej_80xfuqpmua
改名字大全,175,37,138,1,40200000,http://www.baidu.com/link?url=CvcsFLpVvoVqC4rEgcnWpoxBRyLjoj4Qji9-9IUjAw5yjFMp6j2lYsqaKMyj83iied5VeLGemprmv73Ett6Aiq
网上取名,175,74,101,1,3870000,www.yw11.com
网上起名,175,45,130,1,15300000,www.yw11.com
免费起名字 女孩,174,68,106,1,18200000,http://www.baidu.com/link?url=IzIcIYx9AUFt7N5qh2DLPcehF4WIQhakzds58RVTMn3tcBx88_rGiWYZ-Q9ff8Ti
百度贴吧名字,174,56,118,1,14700000,http://www.baidu.com/link?url=_JBSZQ4MeFulDdhSd4vpZcrLQLAVg8p95uxRhFUtRivbEnORZklrPMvAjU6As5ZeL4koHtx-OuEtHR0GVlSmMq
yy名字大全,173,72,101,1,8530000,http://www.baidu.com/link?url=3npzDI6stTmVgA_-eX8Q0WE2w39DCftI9wcJHLV6UovICKebp7w7cUsoYHqAjWM9vasU9bpfWnGf19uK_hSfFk354f5t5M3avsAYHawQscW
男孩好名字大全,173,50,123,1,10400000,http://www.baidu.com/link?url=cqJ-HumjNapy4uRvaPvhHq05o4UMeVX_T3jLa0rkymkbicfa3jH_xkRy9gUnJhXrH7W6mg29XtxqA2u9jZTGTJs2Aj_PnZDOuCBJaJLAu-q
外国女孩名字,172,64,108,1,4550000,http://www.baidu.com/link?url=NkJPbO5jrbcC-f2fzeLbXZRunDSqMq6t0LtsI5rVQitFNLv05NP0X0Updirh1qZTzygrenBYHA52eYVmxoPEg1zKr5fombnHD3-RIrzrt0e
免费公司起名,172,78,94,1,3590000,http://www.baidu.com/link?url=xqqYl8sAf4ozd7USFhPHr0iCeTJ4ngvD-25tbXD1dUEazlx0FjJtuy19LpFLu__3
免费起名字 男孩,171,74,97,1,16400000,http://www.baidu.com/link?url=wsHj4UNMTSmy-8f4If1tqU0gAIEQNnKGNjc5arCSmHxHByEUy7XVycR2kLlCZkNE
梦到大蟒蛇,170,8,162,1,1640000,http://www.baidu.com/link?url=sulGkgEahGuMvpnFDo8q3dnP9H6mBh21L9s3j-NafxH3-HDWz795upCVXQ5Dwc2rN24RoA1vooxT-ZtfV3iT-_
起名公司,169,78,91,1,6700000,http://www.baidu.com/link?url=zKUT7o1hV0zN9ftHUdp6PSkNvflBAZnScaQhM3dnZnxl_PgDIUEu_dSlzfktuiHf
给男宝宝取名,169,73,96,1,933000,http://www.baidu.com/link?url=v5HMB-8eP33uxBYPANagmRI8IKpioKjxaOSJAAShv5InhxfVFrHH-N_JYfZXw8orx3YZXEGJfjndl7KKLhkAIqkSJrhGuc2jBlh8zkx2nS7
起名字网站,169,89,80,1,14000000,www.yw11.com
传奇游戏名字大全,169,76,93,1,937000,http://www.baidu.com/link?url=MlAlcNDWQyteGCbfGv_o-J_4j4-ZIj1DS_QyhFU89nIiVFGkkOxvbuzEhwYH8j7m5MuyRjKGzRT5j7IkX00iO_
cf战队名,168,62,106,1,1080000,http://www.baidu.com/link?url=kovQAeFSE4eajmK6KX3eZpTgW3aD6b59aIm8SIV9ftkVosH8gfDYBgeH0lyxmWRetCbM7rodmtWeV-Luyk6ELq
好听的狗名字,167,44,123,1,19000000,http://www.baidu.com/link?url=JByqjhxoUcXX04ju-KBdK96VWTw0EpzZGmsxsJLsZtp4FXwxM5xhEYN02FtQSrJA-eVjSUp6gm7AgfwvJ592-K
给男孩起名字,166,75,91,1,11700000,http://www.baidu.com/link?url=60vLDTFQTcFzVbVjQwswOzb7zkQGnycGEYwW-ez80IASi0E3K1gM5GXxE2jq-_XcRNOElzDu3hp8CV2vO38sglzFjlsBXtxRF2shnGLgxii
孩子起名大全,166,71,95,1,3950000,www.yw11.com
新生儿取名大全,164,91,73,1,16500000,www.yw11.com
lol好听的名字,163,54,109,1,6630000,http://www.baidu.com/link?url=QYSxuXsvQLszBcKdynijPqITU37Pkn_7UQBM1ZD3yqUZ241F5VriksJhuhUXzuLXOByNLCf_Mo1361QnzxopWa
好听的英文游戏名字,163,69,94,1,4350000,http://www.baidu.com/link?url=A9iHWAkivFbYkGuiJEGiPOaNXiptQ46jVgPlZz8b4QpijWPbN097JB92l2u5-nzTb3tewdR_OYRh0nvty6cIGZvKl7Z0ac3SPixOkUspmXO
新生儿取名字大全,162,103,59,1,12400000,http://www.baidu.com/link?url=jp33P7e1k8i2qmSbZldEZyGgztJOOOBiXuXW6gaqwYfSZM9lBGscecmlKVO1GBd6
孩子乳名,162,35,127,1,4180000,http://www.baidu.com/link?url=yLlMnn30u8TrznAu2uS_FzSC69xtJJfXbXx0i8Arj98e6urLd_6rSwU0BY-Ot_PFO838hJIg896EorllQyNuoSMYC_5-FArHNN-UbSoI4KK
装饰公司起名,162,79,83,1,1190000,http://www.baidu.com/link?url=iVxpbr8mIYClpII1AEu43TJCd-ZW_9HdQLYWKd2ejFukhwuWSl4DFPix_WJiTrRuymzW-KHUw5p248y_Xfvp6K
韩国女孩名字大全,162,44,118,1,1700000,http://www.baidu.com/link?url=s-zoo9sSfqTH87iDXqR2U9blBmzMPBqzflMOOWmRX4Hs83qAKMJYZkEP_17Okn2VjT0OuYKEeVsRuPMiwD6ew0nvf18RIQUZ0ipQr37OnUy
小孩取名大全,161,68,93,1,1830000,www.yw11.com
李姓女孩名字大全,161,87,74,1,1480000,http://www.baidu.com/link?url=jLj3GQWiVz0-zRxRc71BzC00Mzv3buKJcDk_QZrf0C90M7NNIaCUvLi60TYmJfUVn8CgVou37HmGqMJUMiU2P_
宋姓女孩起名,161,45,116,1,76100,http://www.baidu.com/link?url=MpdI3jCHHJgd-NF_y_9pUwSVWzNM0mZRFZQdDRjWoNGZgDwPVHpGLvHrXVVQhH9MBgJwT2WeM3cMDSRvkGTktbNViBDj2iCToXvUpYMJN97
穿越火线战队名字,161,65,96,1,1460000,http://www.baidu.com/link?url=zqIbiJv8r-vN5GiulMkfEG-UsJuJl32g_cyITFQMFDBmHFKewC_CAd_zW06tyZ95Ocy2fdZPkVo4myWNUW2psa
梦幻西游网名,161,60,101,1,3090000,http://www.baidu.com/link?url=2lOUOyarTTq0XkqtdzYMJ0S8b42E7GBPO3qBo8x-ffdeeFSo5h6LzI6PAJLOL6ydGXTUNFOIC1Qs4wFGBUqm_-lbBs2jvfzG6YjBzghZCr3
宝宝生辰八字起名,160,35,125,1,8610000,www.yw11.com
取名网站,159,87,72,1,18400000,www.yw11.com
lol英文名字大全,159,67,92,1,3090000,http://www.baidu.com/link?url=LHrB83UJlUcy6-MhfY_1IvBQGNjG2p8B8xVUYQbT0oq89HolP9JtImxFdFLo1XWLrwLc0uq40j4BijBg9IyNlK
地下城名字,159,67,92,1,5500000,http://www.baidu.com/link?url=WQrbZ_TtaHLRuf6UniZzw8KTB655VozY9y-KBL4zpukAtdHMabHw7POXM59uyAoXb6cz5u1iqugHY7fY8bxC-q
小孩取名字大全,159,85,74,1,22300000,www.yw11.com
袁姓女孩起名,159,26,133,1,330000,http://www.baidu.com/link?url=X0-8saeZnb9xOX63I-Lg_5Bc3CNUlvPzTZQ6ArzvKfIdh90z-SnaZ_XXY2VcZVtpOqeukyfLI1f9fCUrq1orn0ToMA1gBe_qsn0NngC6VNu
宠物取名,158,62,96,1,4470000,http://www.baidu.com/link?url=63rBz259fpDphhuwwCJxnlUadJLRJhdkWdClMIlH0HsN_uF-LVBuySxx5ZCUOnjQM0b0wyDycEc3hyXkHH7NKa
同学群名,158,17,141,1,175000,http://www.baidu.com/link?url=0GKki267FwfLdI1pGGVThJh4A5cXU_AN5jgIwchWHoMbccQorhcPFrbgdR3tlEEvVCxudGAHEzpXd00F3OSudQdBzMHLFSLdjaZOlSx52ji
公会名,158,70,88,1,623000,http://www.baidu.com/link?url=85q_C3_Z-2pENmZOE3Tne9JYnImhQrsGYde6EctEFGLUtSwxrkCFSfvQHl1A82GOGlsf1fB-n1vTGMcv7O9oQa
双胞胎男孩名字,158,8,150,1,3490000,http://www.baidu.com/link?url=dBQmsUpWp6oFHqX2YAy04aqc3Q9K6tJRpq15ft1-GDCt7gr6If4Rwe7Cd_slCna5zKIA2gZYl19AObFn_bkhsf2gXNba7P7xiDy4KQyLmmTYu2pkotJdPQEjCfw0UYLF
广告公司名字大全,157,55,102,1,1370000,http://www.baidu.com/link?url=T5IMCDkKJd_UnEMjHGf1T4cs-rUXBqpb_Pj4eAJLOvOXNuSfMq4tkn9pGRkuc2wDGuloQNBtK6wZrYKxO-O73_
起名字网,157,70,87,1,9590000,www.yw11.com
性感网名,157,27,130,1,2430000,http://www.baidu.com/link?url=lGZv_b2c_HA98B_pXgyR3qgwltnMhf5EcABKfXMOvTKHA5gQ1yPuQpRLkULaq1yas4hciovHfIDerE7r4DKPcNQFWIa3tmOl7eyWnLNCn7hkvy4YdeMDiWqsDDf6-mf7
女生笔名,157,45,112,1,9270000,http://www.baidu.com/link?url=IxEDd8DHJi1KtGQXc9PHVULsYsgNs4-A0RpnaIvmwPSLMomXSy1wNujQ_NPzhZZqojjrZD6SujQ_HU-HosY3M_728pO3cLmJrPTbmoH5Ht9KTCBEF7RCHw7P6m1UuM18
在线取名字,156,70,86,1,9700000,www.yw11.com
英文名字男孩,156,73,83,1,4680000,http://www.baidu.com/link?url=KYh8a6QcWV86fTQ8Rw__HeBJQtWzPTS6AiwYHqY5McLIkfmPxEAkukB7RKo3Yf4kaqdN09FCxjQrgW1ygyMHRhezqs1lg2ijxOCRJFmHvZO
咖啡厅名字,156,34,122,1,2830000,http://www.baidu.com/link?url=0xOx_5u7MlaLJUc7LBbA7gCfdzo727AGCD9R5e14Rvxdis5XchHEtmdt59V5fgyUC37wbMN0rscNX9j6AKYCHK
团名,155,64,91,1,10000000,http://www.baidu.com/link?url=oLKpzfqE0imIWjsKFYU2QN0OX_-uUIkCI2VFjtk42AY156Dz83HzWftgPrvIuAkHx3nl17JFp1yyg__bdzRYzq
梦幻西游游戏名字,155,73,82,1,2440000,http://www.baidu.com/link?url=oLSQzewBUQPD1YQvkM4OSigh4A7SxRQERwOqvGdso_Gy8palSHhRRyMI7drYEv6nUBv_ozog501bFF8UfwVcia
游戏女生名字,154,56,98,1,13500000,http://www.baidu.com/link?url=ePULUtQMQaWl13tVaX5B4inhKZfzWjQv2CKjxligkHMqESxSeZsLQFL9IJNfkt2zuydNY0m7AyLD2uJd69KIM_
梦见吃豆腐,154,17,137,1,2870000,http://www.baidu.com/link?url=5GpeYKUQgiLrcNUqQKuxS6JoRI6-6WHCsnOG1yQqEPLG5hzUliT-SV3t4zjB3ryFv8xhjYwYP6-FjNwdsh_WTq
奖项名称大全,154,77,77,1,10300000,http://www.baidu.com/link?url=aOkE5knVXGRQCMDvi5-adUZ_xxq-j4mSLg1GvpeDGug7L2mjEsjenKb-0btvQM8YIZ75njmsoilshvueVl8opE5bRi3ibawnB48We1JlVnq
公司取名大全,153,26,127,1,16400000,http://www.baidu.com/link?url=EH67FJl5fBCUB964MxPkkedaHINPsMrqv0EbqWYIqRG9i0pUeEG0DJaBE_dnxRSH
测店名,153,26,127,1,1040000,http://www.baidu.com/link?url=Tb9VlU3y5gu6g4kIolwW8NAV3pk-Nah1hi3Oj3Bz5GtV_uvjK2-BNRnJLzOI2dx1QWsQKEZmP65Lu3f56bh6zK
女孩取什么名字好听,152,35,117,1,46500000,http://www.baidu.com/link?url=zMFsOyXf2R4a5tPibyqXuy3rY9FCiwSkUhY2zfM0oJ1miR8LgFFpxXdkL8vMBwMd-KQ8gXFGOdA_23cM7UExu4qmRh-ozDJaJLMe9yFkY5_
最好听的英文名,152,54,98,1,3420000,http://www.baidu.com/link?url=tMLzZJSj_kTU7GSOEDgSqK2QnKQlz0ndWtlf-w_Kb3PHeBWOaw2r6IXz1N7u91lssud_e-P0C0V1CNv97Dfuft8SjWti0gVJ6G6NORZBaf3
内衣店名字,152,25,127,1,2080000,http://www.baidu.com/link?url=9lBCkiWcVbRqw4mK9l7wnresiAqV-Wkv5kL096V6fz4z4os8_htex_meLr9RvGhf10PzCAbXiXXFHQMwQWB10q
最好听的女孩名字,151,62,89,1,22500000,http://www.baidu.com/link?url=4A-5XrkYfXGY1e-fh6vVqfAllAd5_6RGslL5o2SJ5sryWsxWBn41zAkBcizGVTUT0dMomCON4CfF1DQvdQecl6SHo50zQ8iMVwUdNmBQFBS
设计工作室名字,151,74,77,1,2470000,http://www.baidu.com/link?url=XvWq4GgERU5U0aLF9xX5MLDHf7AfjgNyVThqre4XZb0qXK383jGjriyTXr8hzkD_JF98BuASspyV4cBgvUqo7_
龙之谷名字,151,62,89,1,2730000,http://www.baidu.com/link?url=bGTk4YSw7epwYl4OrCrjJ-zxoDvVoy1AUr4arR77MU_IMpFIVsSiFLIjZ8p8S3WZHX2rBTFHspABt_R6Ll0lihXEKcyiwdtfpy_lUA0iKF_
取名子,151,65,86,1,16100000,www.yw11.com
诗经 取名,150,74,76,1,3700000,http://www.baidu.com/link?url=Ya3SHb4aDCvyZ1nm0comEcLcouxHjhojRDg5YV5ep_ftBkfcQu746Ou8aKKy6hEqIzl1kpf_0g9o8vTT_ni0WXxPMsK30geyaJ-IJJQaqF7
梦见黑猪,150,9,141,1,1100000,http://www.baidu.com/link?url=TUE-WkMeDhwfCBRyQXMThsCSZlJgdIEIfinQeZ3biNpmaHnFWbo_NMR-8ACN_xaaHq2gmCsw637woIZKN1YnqK
玩具店名字,150,44,106,1,3340000,http://www.baidu.com/link?url=jf80Fn9xz1MmAiZJ_xiUMsnUQSxItio8YZ51DIql1okD4GMtzbrYtTvlkT53cYxR0ezD2Se_X7B5W_kZk4KvJ_
给新生儿取名字,149,68,81,1,19600000,http://www.baidu.com/link?url=-Evt1w--iI9u-49sb-wFzwF_kXFvm4wQvV2C2ezOERMGyRBVNZQiqoMCq7FPJIT6
取名字男孩,149,72,77,1,25300000,http://www.baidu.com/link?url=E1faWohyu9MvkP-ywm2y1vqFHsxCnozNA81WWPn5p7s2FB_F72mRSNsSnKop53ZrZLliW46Z_momWJhV9WL_8-8StLmpXDSlM691LajxzEa
免费取名大全,148,68,80,1,4810000,www.yw11.com
崔姓女孩起名,148,37,111,1,251000,http://www.baidu.com/link?url=CuUb21vBlvYzpJatqYbY96xyYqaqMyb5UeU28UabSjz8FcNJ6_vyidE8okhTDPm_-UjTRyxvEZNFtK4-YX2cv433yRG_5p6bo5g8Gwvhaj_
女服装店名大全,147,9,138,1,1240000,http://www.baidu.com/link?url=cPoXrN2uO1FTSZOUpF_rebZ4NESMtEHVe5zl5rI8GEm0qb_eu2uRBabtPqpAU4QI7sWIiBWqewlHNKpTakKQJK
男孩子名字大全,147,44,103,1,8810000,http://www.baidu.com/link?url=zGHUsVZDKTMY10XQ8PYrbAyFvpyjjOds47VWUa1IYqTBOt1EKENh4pD7ZRu4RHqOr3okYcc1GsS7fGjn7To6cEnNKRqtltzlSd8SeIA2Siu
好听的男孩名,147,35,112,1,3110000,http://www.baidu.com/link?url=IZ6wClZv9ltq_lHRODZ583mk0BKNEzvKYkqZG9Ks3MTUT052R_DHR4JL-pnN_0zHEEEec2NU_9DycozPuqi1-QbmTHGOLcbKlDR3dUhooEq
张姓名字大全,147,44,103,1,902000,http://www.baidu.com/link?url=2lwiXq5bHWIX6wpvo4lGEifMW2_aM3ZLNVBLOGZxCqj-0kzKF0zDhbSIyhoMnFcRg7aJNeWYjoTWvh8N6LUJoK
姓石的名人,146,52,94,1,66400,http://www.baidu.com/link?url=Q2TsPF5KAr72Vt2u9Zk29a5Hhhu3jfSuc7hIS6SCuRoHDRyCJ69k9tkpYgihUJWFh-HGfFKnpwQHVKubzv1MPK
好听的相册名称,146,26,120,1,1300000,http://www.baidu.com/link?url=2vQ4d4SoRVorLmbRLWlgypjQqlntHdJazHXe4n5yEglvykpniElVf_p3ZMpiW-KEvcInYSmFrBAJjpdrH_Gp0dES8w-FPfINXDUWDp6iSPy
英文名字怎么取,146,61,85,1,11400000,http://www.baidu.com/link?url=3Nzm1Giijxhklf3llP_Gjk0XB2O2FR3uPhL2JZZRQ0XeTOvEpVsgIPPNKr4hIAKJl779x8UyScFMhRab8XRjbYyW-OJIQNMxsaCLWrZCcv3
地下城名字大全,145,45,100,1,3720000,http://www.baidu.com/link?url=ER2bDkhcnrh7y_ReiSnxJwlKX7SQyMOxtVOsN8Lbk9q1ol7kCri980aCtk53ao9pjPkAN2_UzP0F7A2pBqUjwq
dnf名字符号,145,75,70,1,1150000,http://www.baidu.com/link?url=Uk9sB_QUZeCqo33RAhxnw0LmDZxXBqAhQWLygIfMdQiwW_0m6h3LYW0-cTAGWWDSZa9Hv8kySL-_TjaWBiN0nq
名字网,145,36,109,1,17300000,www.yw11.com
艺术网名,145,36,109,1,3540000,http://www.baidu.com/link?url=fsKuWBUXRQSxdskQj214cPlR6DZlJBa6-sIf4qn-QvGlsbHXt3PUtyKWR_OwZMoQWidTz_EWHX_sw2r1g2q_7_
取个英文名,144,62,82,1,3710000,http://www.baidu.com/link?url=u_wRRMK_7Ij0JOS0TieyX0ACrLvt6by3YAJ9izk1TvSAEBm_pz8emyg0OOBW-rEt-5Cm3kXZlY_SkETuim0b8s1iobvQhQ5k4REC1nvdArO
起名打分网,144,60,84,1,1170000,www.yw11.com
在线起名字,144,75,69,1,7090000,www.yw11.com
公司起名网免费取名,144,81,63,1,15600000,http://www.baidu.com/link?url=XfyQlp4LIZx4276tjb3yI49zk3KL-P4FZpVjATC2DIR9NkxrY_fi3bJ8oMXomBjo
给孩子起名字大全,144,57,87,1,47900000,http://www.baidu.com/link?url=L55p6Ent2CZ0VqWqNqnyETnFnIBfGe11W8hnmZv6RAKidbFJCaWH2DQyiDlvdc2yRmTORZfKjwXTW0CqKsbQMK
梦见好多猫,144,0,144,1,449000,http://www.baidu.com/link?url=GHqwbO7Ku_1uKC3OzELXNvWJ0flAR-cAKx8PTIU-ojT2KqZFGFdlwugu38v9geHVsAMMQPz5vtDNrXBV6ZMGO_
小孩子取名字,144,70,74,1,14600000,www.yw11.com
电脑起名,143,44,99,1,7530000,http://www.baidu.com/link?url=qOW_2G87_3zzz8AhI5ihRswo-Ze8aq2HWFqqQDctaXmTKHF12MRffQ1sJtMBUm6I
康熙字典7画的字,142,45,97,1,11500000,http://www.baidu.com/link?url=rz_kyfXxUz6OumcnG0FRVYJpXu1ruQYl6mIgtFqQ1HF4YXpCfByp0pMqoehpTywdsGIRQjQBI0AynJnLqn518TNQ8ZKLDuHqQjgD63Rx3OG
饭店起名大全,142,8,134,1,1580000,http://www.baidu.com/link?url=0Aj46ZMVljuh3Ia6UnYocV0kP6043Z8r-kAr8QFPvsBvhWvQ_HpmecY5c_mxWdkwB4LsVHzFB2tUl8AKNbkNFq
婴儿起名网,142,70,72,1,3600000,www.yw11.com
女孩取名字大全,142,66,76,1,51800000,http://www.baidu.com/link?url=knF5W-aQCemPMUKkaOgOSra9uPH2y5zROVcO-Vzttd_AYxCQCw0AoH71DxShDJJ8RvVWq-t7C14cP8tAOSar3paCg8EpAcE7g5a_KtHs-mu
给狗狗起名字,142,8,134,1,6130000,http://www.baidu.com/link?url=pyMlgXMFmo_zeTh0jV1rEuHsc3k6hiSJLiMoC5wIaZ_Dl4FtQk8k6z79_iHNekII-_P5ZpRIuLeMdOMb9mwPKa
专业起名,142,55,87,1,7980000,www.yw11.com
怎样取名,141,69,72,1,10000000,http://www.baidu.com/link?url=fJKL_Eo5hdGojfBzE-Nd_mvHf2OtdE1OqPTookIYxu0GCEaRWQGamAI8pVjyxLL_
起名字软件,141,46,95,1,3570000,http://www.baidu.com/link?url=blcMMsyE1rGWJINnn4t5RxNwZZbMNcmlQOA6X2HtvBtDEVzUsbq3VzRAbyY47B1e
如何给宝宝起名字,141,68,73,1,16500000,www.yw11.com
好听的帮会名字,141,52,89,1,1570000,http://www.baidu.com/link?url=4HGzWXH8NCWG1A6FY90WUAbpUvJyWRfuFz1wf7NnR-CTQ2JS5h3YyMWAFMgF5juVRlbeYSjaThKRzAZHA8hFEq
霸气家族名字,141,43,98,1,3900000,http://www.baidu.com/link?url=33G5lzYqoU8J4PBaTdQsApEnorjfNobz6625iatcItKXrAVViOM_3a7ISimDogRrjNNA1Bsg4ZBAVJX-9E57da
美容店名字,140,61,79,1,2060000,http://www.baidu.com/link?url=HpjbGTZQ93IkIP3eTxSXAYLVBbd7WjTZt6Fc8d7aPp2NkElrT8bvSLnJmILh6qYG98gAOd33cXLJhshdWVtET_
姓刘的名字,140,9,131,1,2620000,http://www.baidu.com/link?url=0BHub3Nw_TqxVl8yZ6f2mQn8ciRV017agXbyKThwSgMHIMP7xFnQwes9pGbarLpt9TxVvZq33Tw0_iG4jvJnR3WUyF66rIS4gpogwcy_-Ui
魔兽名字,140,72,68,1,8590000,http://www.baidu.com/link?url=WTrOm2crhSOaruueMhbHvP7StlOMywVY6k40mkSm3gHHchOocORWhqg_DbJD4dBDzpWZD-kXGmeHdfX_8xVCwa
起名字测试,140,45,95,1,5430000,www.yw11.com
公司免费起名,139,61,78,1,3890000,http://www.baidu.com/link?url=mRELvayFfsf7lHXeDGlSYHSgA7a7K0KdNgtDt9RvAaaneoxyM6Uh049tzr0IPqq4
女孩好听名字,138,45,93,1,21300000,http://www.baidu.com/link?url=OB2Y-s2M4NMy9teyCLETg8THbm9gpXIWUUQqI7oLf2gFyPGnTQiRUulG2BmRWlKGajeau5kQfbCcuYi-mwJumeepyBSVte0r8NTa2OqrakS
好听英文名字,137,54,83,1,8550000,http://www.baidu.com/link?url=0NlfgT7TZoJhkMtTyV8Az6XyelsTZYKXxXjfdwBGvEPrbjeYgkmC_Xb576xRHrVUSKDm_jDox6iyN20nDErKLWozVrwB1uid7SLEW6p1ne_
传奇游戏名字,137,71,66,1,3920000,http://www.baidu.com/link?url=kurVeTkEP56L21Og70wrlo1q6euJzJDzGew26fmmykndmEnML0JjyPmfVajr56xjASLYWWZonKFWn51p5Z24ea
好听的男名,136,42,94,1,2360000,http://www.baidu.com/link?url=Mv7RVr8Sm1ykRir70juarl6KAPvs16MFIWtctA-J8sQCzf2czD7FMUTdxVau1pdBFfhQ73MJwMY6gFHKxaqRShnQ-0fE20lYMEfS5nGzXJG
好听的家族名,136,63,73,1,222000,http://www.baidu.com/link?url=8O8Sm8KjridKb68leMWTNzuZ4aj8x_zPr0LVTfXuzcf7UEUxXwPzjzZDj4-ENxIt6hrkXTiWCz2ElcleDptjsLo2gc5TSqWdBC9Gkxv4eq3
给婴儿起名,136,66,70,1,5730000,www.yw11.com
免费在线起名,135,61,74,1,4040000,www.yw11.com
小孩子起名,135,67,68,1,12900000,www.yw11.com
霸气的战队名,135,36,99,1,131000,http://www.baidu.com/link?url=peeyMzqOUbe9rY8lW2GIjmK002AMOC9A46dSSOnrQUwRtnjCylQnde_oFdKv1V8HYHfYIVinHecDnnLt0ndZULgxOqX8vBTyp1tJtA6p_QC
名字测试生辰八字打分,134,70,64,1,9410000,http://www.baidu.com/link?url=1oekqCb53RKxjzWbu0TzpTaVvaRKrQ_3mAlslsGDTSyWop2EgUdjRcNG2kSsQwvj
手机店名字,134,53,81,1,27300000,http://www.baidu.com/link?url=L2q1hjuRLUIQahSbpQmnxhgWdNd-rNTaajLBf3Vx6qptGCK2KYgUs_e-1B7Q0kU_Fezgw0k2d7Edf6U7Reauzq
女宝宝取名字大全,134,65,69,1,17600000,http://www.baidu.com/link?url=s2fwwYvNQsLKDewuEZohHSqOCKYbPuymE59M0XvbC9WlX2LkZqiuYEGC4FhXi6elVgiDbQOkvVSMz3oWvE3a5CTwvVpdnhJY9-fN4KH9H3u
起名字女孩,134,52,82,1,15600000,http://www.baidu.com/link?url=57aywD0Q6WTnl7XKbIHuE8b-omKc3ap2x5EsTpVbV639-5V5K5v5r6a2VURSEGnQB9tqxCxcbvY3bSe2iOahr9BrxfYPKpUy-UDTWmKXqmG
面包店名字,133,27,106,1,5050000,http://www.baidu.com/link?url=weO6NIXmj4992ZsQUNYFy2kWwEvh6dfZ6CuWx1uk5pGoptNtlMSB5SAsksPLBltDHh9nD15wEuFuGYwOFhHR6a
小孩子取名,133,66,67,1,8270000,www.yw11.com
宝宝起名大师,133,33,100,1,8620000,http://www.baidu.com/link?url=86tQjaGJl0NioRhn_fyWPhvrCAVAh2dGGALDZw-WhEwkkV_FWnSW0DSM_Y9H5hCC
瑜伽馆名字,133,9,124,1,1760000,http://www.baidu.com/link?url=YYoOLSXJXaBozp1Dc8CnGP9OQLA4Q260rmRjSGqFJkDzpmKO_GNTrfnIxxCPsWkFpLTi65mPHYK4vDJoAHlKtK
好听的名字男,133,54,79,1,20300000,http://www.baidu.com/link?url=0-sfAw6_jqw1MrM6T2yfuTEW2mKTFX2E91hx7P-jBOlk3ZY5L4n2bDovH_6WHuxtMFOQbiOlB7OFCTqO61OZl8pdhpxG5SGhWRFDYCk2pPm
武侠名字大全,133,53,80,1,3180000,http://www.baidu.com/link?url=EcWLYwdnahY8IMkhEO_JDaMMd9_r4wlLf_ai4UNmi3PdSE4Gm2JxYElJMVrJ20IX1eDwWQ4Tcih48KI1yshaC9pfMjyWeYwxzqRPfyFe6Y_
李姓名字大全,133,35,98,1,1620000,http://www.baidu.com/link?url=l9fccLdeJ4MaX6n4yz4aWGvcNtDbXYQP6QdKIq2i-6qqtnX-t9IJT3cAiWS0sUQ-bhSMUIy3AYhwpJoBaeKtGq
好听的男孩英文名字,132,53,79,1,8620000,http://www.baidu.com/link?url=a_U7HjTzj7BNykEO_zbjzQb61aWHZMdg1NkIOM-ei8x0bEE2ScrP6Aeu2IgNSK-zitcoc9shPqohuCRTgiihcOd1hf6ijIS6J5j3SR4BXCu
专业取名,132,75,57,1,9620000,www.yw11.com
帮派名字大全,131,51,80,1,8350000,http://www.baidu.com/link?url=-vpjW5-L5AhYC60PBUteUpzJOfE7pt6Zi1vq2grJLC6-pncCTWctDu0u9W5c9jnF1pYqHtjHAYUSwxoDc0w1ya
韩国女孩名字,131,25,106,1,3350000,http://www.baidu.com/link?url=_TOhKB9vPX7M-O8JoouftvIDC0d-H5IzoZ0i4VuUMc4QxibXcmHk1OPPhmx5_hdnFZCDJrwqajyN2LBUUJU3lX6TMo5vQGcqo3FMXU0PSf_
取名字网,130,68,62,1,45300000,www.yw11.com
好听的英文名字女生,130,60,70,1,10300000,http://www.baidu.com/link?url=AHd-kh8_PtWP0rCcuaMwIT16O2pdX7IwL86Ihtp8tbjLN8KfMAJqKPnOPEXV_eUGpMW8L4c8xfviyVNSqJ1HGss5Qb2Welm___INSderg_W
起名器,130,64,66,1,275000,http://www.baidu.com/link?url=0liB9UYpq0FzG73BqAgqwN2M-vZlyZxS80XrBODqZHYIajRoCrgVGu_R3JRLGT0a
好听的组合名字,129,42,87,1,26900000,http://www.baidu.com/link?url=_T9XE8U-jPJmvxFICt7fve7_dEwgggUVMbSX4MlMu7sboBtT8rQTULNaUnotOm7zXqCj0ZyFMYYamULQ7ljEB11leHbW4YkJd6CuD82mTK_0Wvv_Z9QQCnhi9Krgul35
魔兽世界名字大全,129,54,75,1,2280000,http://www.baidu.com/link?url=yjTmi3bwteNHv63wKY0RH06j7yM6RQjgb7HPO7PrgjLdcDZbh_eTuHkf9rRb80JTPwdYehQ6s07Xhh__9Osaba
在线取名免费,129,26,103,1,884000,www.yw11.com
餐厅取名,128,43,85,1,2660000,http://www.baidu.com/link?url=A45wv6-EQwUjoZFFx18PXGUspXsT3aFkI8WfZhkbaeieeriTqyX_Y28T5OoEonexQWc7v6j7rm4tFKBcN6_-t_
八字起名打分,128,0,128,1,5780000,http://www.baidu.com/link?url=eR_WneAxyYPNIDqdyynC6G8gc4mN1CtIX8nCjFduyA0SM0rE98Sc3yhj9AHqIElR
男宝宝起名网,128,80,48,1,1140000,http://www.baidu.com/link?url=NwSwLFG-X7Sql7EgUMbF1YwWzVVfZN03SGaPYroRro6ZE2qAwIdYGJPISB_Do9m2ZnTt8oLOS2AGhb1U3n4-arJDmw1dsatlBBNkyoCIcxy
逆战名字大全,127,42,85,1,1000000,http://www.baidu.com/link?url=lWcLxOUtVY-e2YJBKvbqUQ9TBQ8m2i1doq110x5BHOmTNZrIcgi99j6hjyfwkXhH6dkb9fGelMWhEl4DcUaJ1a
群名字大全,127,26,101,1,9200000,http://www.baidu.com/link?url=o2QCPCZ9BBpWVqkDM0RU-KG7qma6VnNHMvD2Ax7pfdhYDL9Nx-v1-x3WXlYWfAh1xzKxBi_wj_IXczL-l7kXciJNYYInkIPZFlAqJkHA7YS
霸气英文名字,127,26,101,1,4400000,http://www.baidu.com/link?url=BLQbTP928UvhvY5YVJ73qozZM97u0oTgFLi3ZGajOZG62Hac2ubRsYQT2DBDtmVgVzPIwlNiiNz08THu2PH_uDT18pAHafRTMkSIMZNt-G7
御龙在天名字,126,52,74,1,1350000,http://www.baidu.com/link?url=KiY603gUuFVmN6sQUTpeNecwzhpMkGiK0dlMb_TTWDxHZOGbum9p2WNAC5EvBRLs0uXxGLSP8GaFHC7lV6ErnK
生辰八字免费起名,126,34,92,1,9030000,www.yw11.com
起名的学问,125,55,70,1,5370000,http://www.baidu.com/link?url=Un7gdHoGLYH65hJIXIeKWIfQIvL6Cu9OoD4Noxzed1R2dQEp4efPKipZABCUBo8dLUlP0U2bC1eX2CL5nczvjK
服装店名称,125,44,81,1,2290000,http://www.baidu.com/link?url=78SVFBpOHiRwI0ZjzOjZtU6hMWM2VEahdCeY1kP-VFg_uPm4lO1yUQGm6Qs9yexX-6iSEaybRfNzAz3F65OAfK
男双胞胎起名,125,55,70,1,2960000,http://www.baidu.com/link?url=l_LAOcDz9aP-kBAlAz5O9QS1Jy21emRNWelAWcOoAD6UkEczjwWGbtF3Xi9ThhN-vZbk4STf5pGP1Uhj2RVcb93VrtCrnM0eoSjr5DO-IzZ9VUPslOOUFUONRtG_cNzO
男宝宝小名大全,125,35,90,1,2600000,http://www.baidu.com/link?url=ObkRpNMLgu4GwG3XsFUoKUlP5DC8PRjyJsyuFMwJIoU5nfisot_FzXlk_5ncCuVXIGOAWiDhNUeu8YVtjEhSiI-DVJAJSXI7R2UCEdUiewy
取名字 男孩,125,0,125,1,13300000,http://www.baidu.com/link?url=giOlBkFVEvCOrROl-xA8h8BglFF8fgaeu42F-gYrISvotS0q_P-3ROj_gSRMrYgt1Q9zXSFF4zHdO9_EcJEciNuVY__7L9y8cKMrRs482Qe
张姓女孩名字大全,125,25,100,1,821000,http://www.baidu.com/link?url=1aRW5zVYEhALgjw0AEp120wE3CB4TXaESfWjvE2sg4-XvhCvmY6RFCFZ6RyJIx1qaGnkqM2MvFtQ1LOu9FIznq
五行八卦起名,124,25,99,1,2850000,http://www.baidu.com/link?url=MC6MmNYkA-MYMiklSc9t5maHiFmczDR8PHbEl2dn1R3-j-ewLYqCdP2QOV4Rliue
姓名取名,124,68,56,1,100000000,www.yw11.com
宝宝免费取名,124,74,50,1,6310000,www.yw11.com
游戏搞笑名字,123,36,87,1,4430000,http://www.baidu.com/link?url=UTxRWr9JWaHHxwv3aUpWQ6ea4sZADff_uh1LuRgfVjnXMC7UJJ7vpWXV-2V_HN81sgkOZaQ0tQfGbUsq9wlyOa
如何给孩子起名,123,70,53,1,9660000,http://www.baidu.com/link?url=JmHSJr-e53qzYyN-aVzIZUNbkKxXMO0Pzh9JBoylQJ10wCCWUamtjO6hvqTkVdqJaIpkpJH9A5obgzj1FLXKTK
双胞胎女孩起名,123,48,75,1,3230000,http://www.baidu.com/link?url=Ckb8NewYRehRXROXFm9ShQOVh9s20TxoiAyQyQEXlHd4D6GpwyFYWbX4in-G42gvw6UoDkV7wJ4nvIcnDz9JfU8SspumIg_SbN328ibluk38osakH-vn-fgbKCOMfDxD
小孩起名网免费取名,123,84,39,1,17400000,www.yw11.com
游戏起名字,122,45,77,1,8440000,http://www.baidu.com/link?url=826MiNuH-STYMQ9r25osh_pU7pMi5BLNz5sHHnQDOkyEGk2av_bWem_24HU2Msdv
店名打分,122,33,89,1,2010000,http://www.baidu.com/link?url=OfAjW8AsH7e4fn99Z7dfutmqfBwvG_LNOG4Nmnm9tNacztYMvzYHKYFexPEyP6fWku84fyXDUdGSx-PJYdIHDa
取名字女孩,121,9,112,1,35400000,http://www.baidu.com/link?url=UgsKGKLqX6N4LWm6XFd6MC1h22Kj4qG_WziebSmtNYKxXLTkyqFAIpFEay22XGJNOcVT1cvwrEqlEN9GA4SfdolX-yt_ty--7o-MDC32pN_
取姓名,121,44,77,1,12900000,http://www.baidu.com/link?url=ZR0OmzQR99koMjuh7xwwy1RdsQ-BAdiwHf2f4fnVduRhvCviLIbzUyRix2_ZIU5N
好听的游戏英文名字,120,64,56,1,30900000,http://www.baidu.com/link?url=O5DZGLcXbkvzgv5VOhH3DFoQOlREwnImgWDFXUd-950GfYd_m4vSegRXrYtu19A_aBdQ6S_hVcNGrXmxX4iHzIruDvlrjQag7z9jP5o_ki7
起名测名,120,26,94,1,4170000,http://www.baidu.com/link?url=sdxQGT3axaCePpeOBdSXBqyRfNLHqmLLCnGc4ZfHwrbZnyKNL8jhXo9xFzDmn05Y
狗取名,120,42,78,1,1120000,http://www.baidu.com/link?url=OCVgN7c1TqiQIKnqzDYzm-pWMJocVe7-jGbRBjH3FxTYrVR3tWudl_O3VQSHJOVMo-gkDoYLxul8XE9HOrgUm_
复姓名字,120,8,112,1,3310000,http://www.baidu.com/link?url=MGFI3HqZjiXD8K_7TvkdcmZJNCBVJMbiLQJc6JuaK0Cyo4Rg981NQ6tjzZRDvZE6FYOU5-LTef8TbZotuD0NIK
服装店名字大全,120,55,65,1,1710000,http://www.baidu.com/link?url=gl_5DfjjtszZYRBjwlVDv4Sc5pHqHjUOoaXBfRQOEhmI2dKtfptKHsFA0q6mkN65wLaCcTNrt1umyyBDHIddGK
女生英文名大全带翻译,118,61,57,1,4530000,http://www.baidu.com/link?url=FjheZMLaiFmFwMCZP5GmoMJ2NAJKCq0V_W3_yNsQXwhzq2y2LzPau5RxhLRCUbB7xtZva0B1-EUEghLA9_FfSfxTzu9L7FDIpaGH7S-6CY_
最好的宝宝取名网,118,110,8,1,14700000,www.yw11.com
yy频道名字,117,71,46,1,4670000,http://www.baidu.com/link?url=5RNZksxX2upTcWFqmN2OxqXTGAhqv9u1ONqH6R6X5qFLsvswrfpeZ3i19jrWZNS5-bM7egbVRv64K3tzbUhm6ixSo-mHw_ieClnUbheMXnG
梦见车被偷,117,8,109,1,2170000,http://www.baidu.com/link?url=L5DP0z9we12rPFBlU4LyA2cSmqfWnI5cf1tqy8yzzwXLkSiR_IOe-AomFtAeRdyCZ2ipO0PbizjhO-vI8UYCw_
培训学校名字,117,80,37,1,9790000,http://www.baidu.com/link?url=-L2QT1WPc6MWAEvNjEDZ0x7RuzqQP7FgswwhOPUR6HnQenAningojovXX186fII-mi4Bl5uML4bs_e6tOIDIHK
儿子起名,116,69,47,1,13000000,www.yw11.com
产品起名,116,58,58,1,5030000,http://www.baidu.com/link?url=ey2KxFmZOIlXztAtn69ia55G0ahek-kGWmdQP0q2pH5vEK562LbxnavtKh1kx87od8p2WmfsNWxXScwlTr9ibK
好听的服装店名,115,17,98,1,464000,http://www.baidu.com/link?url=KhutcUlLxgiAgKMNxbtHcxCiSnugMFvPEBjA1lD_rHUzH8mFGA_q_pgZ5WFPAGVZoq23Adv-s8a3W8Kkx6_cgq
免费公司取名,115,43,72,1,3170000,http://www.baidu.com/link?url=FGOBrYHvidj4u_GUgBk6ti71B4WKr_CraCCF2VBcIHgdFTRNuh23d6oeN_b94LgD
酒店起名,115,36,79,1,4120000,http://www.baidu.com/link?url=Tjo13YVmoFVjg4IY5Zkt2vzUq7WcAauMtw2qbRqRjmanz7wXC8CwSVj4ShyuWpWp2DTZ-R3j64ZuVkeY6OsRP_
男孩好名字,115,17,98,1,7370000,http://www.baidu.com/link?url=z7lyHZWF0uCwAFclOy6HWKV2XkRcmH9B3i5VIynK-OwyORrDMEyfk5kC2CBcsdRCxaKZWOTp-ODGHodJoLP55-EOMPDSZ530gPZE-szgI0u
洋气的男孩名字,115,0,115,1,1480000,http://www.baidu.com/link?url=xmyjEiu6QYVW3gVjKqll6glkFp-3NCtWQyg-p8__kVV-j7GwuItWS9JevLFOZqlGfrpqnV6qQsOIP2uF-kwyzNP2HV0urtIEmGMzDZs9d9G
小手指短,115,0,115,1,3110000,http://www.baidu.com/link?url=kQCw8drdAR7TEFdpcQG8hhqFp1Y9bvW3-6_H9w9o_aiPqIC95JEU0yhZoow72EoQgZVRs6lCv16WdekV9IkVYVu6LR5qJNvYyMr4PBydVfT_mSYb6KM40dql1KCtQxIc
广告公司起名,115,67,48,1,1240000,http://www.baidu.com/link?url=CttBQ8oxwA12Yz2BHS9thPGiNry-j9XZ9UZxI1MkPI2gpFt7oFEYmsrNgBUhDu12a_FSMRlDuTo6plH33ZSuOa
取名字网站,115,69,46,1,22100000,www.yw11.com
好听的男生名,114,35,79,1,14700000,http://www.baidu.com/link?url=Tx2oPHT2_Btc4x2lHShirlyvA4A7J7DPpHQRmCR7aK3-3qDlMZzrdBn-uvaTxItLzqf4O8q_tc4f8sCkjfMlaKSCutun4bL5QbjT_hYQWWm
杨姓名字大全,114,35,79,1,752000,http://www.baidu.com/link?url=8mvQVAwLgTsu9S7JBJKr2XtgQV6MPdZFqL91gnBJtd_mwfQzo1RV75j1oQtRtDWb2r3oM9CuA2T7yJ2oPua-j_
咖啡馆名字,114,18,96,1,4120000,http://www.baidu.com/link?url=m3UmLlqcMaidkLU5WVBufn1mBn200fWJwyD6wJUVNR2Ye6vzGhZ2vVWswAN8X6NIGzFn9Y72Webbbbt1yyQ8G_
女孩游戏名字,114,26,88,1,14100000,http://www.baidu.com/link?url=tQs84DxXe6XiYEEtpHSnIIFnLO4sjq22g7V-0gfBBahNN1zUqEIpF06KbQcsNP1NpCcjzQkcuX9snL7k1xhLfa
小孩起名网,114,67,47,1,3850000,www.yw11.com
霸气的家族名字,114,35,79,1,3990000,http://www.baidu.com/link?url=vDNOnPycsiEUFbVGqVf-epdXWqygMl2ipBh9MNUT_OmtYtNgQPpDBEFtqAdZxvFmrL3TICK_vuiMPLcs8TLhvq
小宝宝取名,113,67,46,1,13500000,www.yw11.com
好听的女名字,113,42,71,1,30900000,http://www.baidu.com/link?url=RcJtpEZpQY28dGIx7qis5mOQyBzcz439d9UojL7Ko1xW2l7q7HQCvq3g05DSknQJYvHWzIlAx3V27LIUcQWEmLIHdDIbVMfCa5xODmXRNB7
梁姓男孩起名,112,43,69,1,109000,http://www.baidu.com/link?url=meRLI8G_OLoJSE9nEmLUvcBI4JumjHPGQn_gvHcA7mIfuRFd3ZfBSO3b9qUVaS2tZIx7KsxmrpbSMMFeLRKaOK
好听的英文名字女孩,111,27,84,1,7730000,http://www.baidu.com/link?url=IxgGejDgRNecoX9F_qdQFU9CGZWM2IwUOqsm4k6MKhhTkKFHGfNk2n_eKP-teFw6sOj9PF_SfJQj2na5OEketGMIl05VKoOu1ZYCusGML0W
在线免费取名,111,52,59,1,5200000,http://www.baidu.com/link?url=idVwus3HQy-uaD0dmeakws-k_EM9kdNmUC-hBaD4yQK2LgJZC2l85g7pEelvliyq
在线取英文名字,110,44,66,1,1760000,http://www.baidu.com/link?url=rNHoytKb3sPvK0jbicugqF4Gx97JqAvblhJ5J56kkzQzlyVtjBLGnxwV-G8dWqWtFD9gojybRL8fa9SM4v2ElvCMxKZ5goctWU9-PU-CAEO
兄弟名字大全,110,17,93,1,23000000,http://www.baidu.com/link?url=gxrUf621vw9fIoHyze5Gk-qNMMfGXwFCSeTDPERd303iTfX3WENNU_W3iCTfb3ZfNx5oFqaurcoIT1Ffeuo7DUH18gVEMAF--oDVUYGkCejtAfBDJT4knLWtyaNNK2g6
男生英文名字大全,109,53,56,1,3650000,http://www.baidu.com/link?url=a_UqE_xWWi750gS7q0YkIc1eau3kL-SnIfK9jTdVGnnbqjFP5iH9GXpJhTlzPYkxFJePQlgGq5zK1_e7Cd_-tAkfG9wAUJxmOj_1syGtnry
qiming,108,63,45,1,47200000,www.yw11.com
起笔名,108,36,72,1,158000,http://www.baidu.com/link?url=jaDu6usfOzF3W5SiLqrEaKjRLzzQCiGu4NKy1qdEu-WEZZKf4tvWuU8YtOfUAqnorr-QLyym25vf9h3uccqjRFZkg0t3RvTYPEiqfK1BJM7hI9cwPEhvjVg8bAqZ2x-B
英文名 女生,108,45,63,1,4520000,http://www.baidu.com/link?url=j2S6mzh9RYqaaRLNNs6H4etyQn7aiSoGKD8Y64dqw0UJcMZ2W3rP8840zsxX1WhTOpI4_q8oXzbB7oAf9AGzGIzghCmgT4gbU1p20EZ1J3K
给女孩取名字,107,17,90,1,18600000,http://www.baidu.com/link?url=FW2AfHGgIPMQtjJWs6bj9amH-ll-C3V8IpJC1pAM4YfXVSmrQF1mszT0MLyaH6qXaO6deUblFcEvqMbtj1JXqLNoYgvPFyAhs6_Cw66Q-g_
lol名字大全搞笑,107,51,56,1,4570000,http://www.baidu.com/link?url=1tUAAZqG50Uv9QroNKg2uUzKkyEMC4ZBMcb598aL6TlIPqhoklnQmy1_kxswPxwLf8HpRZH-IhbVUlKd3NNrza
同学群名字,107,18,89,1,771000,http://www.baidu.com/link?url=zgYxpJWSfRxExqb7CX-G-MpAGVI8WrZEkG72Ci7-O_3OEz7MnNn1AQz5oadcbVWAA4AW3tIb5ohoS5tJfE8fXY9acyLdUn5IPM2Tah5SMii
洋气的小名,106,0,106,1,686000,http://www.baidu.com/link?url=dSbQCrzTlzad-q4xQ82-pNe7gDUFZtPE1kDuOJR5ETtPyF-fQ8bcA8qL__3nUaPIwrq5Wl2gyNN2dAEGyV-wBzPjgXmMpwm4wxN12ooTPcS
公司命名,106,48,58,1,7340000,http://www.baidu.com/link?url=hTEo9gI9hkQkA0e1kVox-Xhob7Lp47Ixs6JNnKU84eH2W4aByPXIxq8GC8TlPCYD
好听群名,105,10,95,1,2450000,http://www.baidu.com/link?url=sXsoCdc-NuUmdC8jlcKvFlJGgXmNB4JG_XnBZfZiVUOf44jXeoJm0ZOoWmkQVmmNE4d7j4IuYXfIuEODhTtlWrBXADBb6m2Lg8pSNtiPI6G
郭姓女孩起名,105,61,44,1,268000,http://www.baidu.com/link?url=Z29BI2bd0ouErRhgNKvrV3qgv3Y7YdITwawS1qpfnlp4G_9yZjjpdS4KfZydFx5a11H0pDSZCHQY3faNPHCRl_
宝宝在线取名,105,70,35,1,3400000,www.yw11.com
街头篮球名字,105,69,36,1,2330000,http://www.baidu.com/link?url=mx9rR1oCFtjA8fSV2HWRvCHp1QQd-qhSDvWyEpgP8wpGj0QQLePt-JbYxI69fudVTu0velPXyONkg5IQXPlpvq
取公司名字,105,17,88,1,21100000,http://www.baidu.com/link?url=6SZhfOrEXezj0hEwqAWBZRZSCJkhqrz_x1vou7bZt_q-dvhKjiqkwKUejWeB5VKt
帮会名字大全,105,26,79,1,1160000,http://www.baidu.com/link?url=3HynnZvRXeX8zRXHSydoqYW0cDJ1OcwOfZFIbAny_XYfOq8E3ccllGvHk7YyeoVtyABe6HCeWZfcXZ0NjDRb3a
史姓女孩起名,104,0,104,1,115000,http://www.baidu.com/link?url=vMFRzXk_KetxtVB5bws5mOl-IUOa2XL_6pzEv_yec98gyROj9M70nzaXmer50wzusA4YNop08h3SNHPnQ6LJTOMCKZcQeggRFs7IDpkAsjm
怎么看手相有几个孩子,104,0,104,1,171000,http://www.baidu.com/link?url=FHNtB4R2vo0TE6Ts5Vu8sTy0fEjCK0GZ0YBt44eeheFK_2YElQ9XGxKeQvFGKUCBhRMSj9-VgnKy5URbmGw8kRYkn-eg-BLpB_6M-dJ_Hjz9KcTIge_Rf9wdqDd0mQgM
男孩子取名字大全,104,9,95,1,10000000,http://www.baidu.com/link?url=0la4xw4DAmhHNlFDj_kbgjgQDb6Sy-9tmvHpO6VyrmORu4R2N43GZD_M1wdnugk4IWF9AhgSApGWeyGKm_KhTxN9yf7eCIX6dFVaJor92SS
梦幻诛仙名字,103,25,78,1,1360000,http://www.baidu.com/link?url=Ag2ddX3FIERapAw6LUSDeCTTvnTA_9kBsM87p2hB-GLff2LkbTqSmhcfxUCAxVLYltoKvbJ6XsQMmx7OqK5EWByLQtwIXDFtY6-JcwpShnq
小女孩的名字,103,0,103,1,22100000,http://www.baidu.com/link?url=3hNOFmgS-wsIFYWnEGcRP_B0CbvhXUCVKiCsXLur8StbgXFWFNDTi4kgj-7TvKkYrqS_0LmLjfped_n4kH8zu47yMtK3FFe1Ew971N6ny1a
婴儿在线取名,102,68,34,1,3740000,www.yw11.com
商店名字大全,102,25,77,1,11800000,http://www.baidu.com/link?url=UgD2UNuI9dMZ94poT1emANm2nO9xWtxUc84bY2FbiCSCwXt7gCM1dC8eLCbsO8IElTXU-kMNz7wIGNWMxSk2qq
大气的女孩名字,101,26,75,1,2160000,http://www.baidu.com/link?url=y-7WcCRne-oKWgrYMpmQdtxG3MDwuPhC1v6cgmhtC0UrMpJBkXbOCqRVpntVhZCCM9yKpfhe5W1JL5yPIWoYR0GRa4HEV53FVCSxwn3d93m
幼儿起名,101,64,37,1,6070000,www.yw11.com
结拜名称,101,27,74,1,2050000,http://www.baidu.com/link?url=oVlliis4tZHTHesb09fe8_ZXw032s7fnAMXMEvW9GYbRcAhOVp3r8yNCrI9BZvQieiL7yPPCBlRE_przOEB3ELZECtOO_PHtl6fqWDMr6W3
起名网站大全,101,64,37,1,14100000,www.yw11.com
舞蹈班名字,101,8,93,1,4870000,http://www.baidu.com/link?url=hrCQHTfjaGo1GWXq50MfYg0xKH6qr0zxuWLyK-cVAa-jb0oubeWMsuyzbufJ2xSeDBkHIaESoZoe7JJ5rl-doq
好听的女性名字,100,26,74,1,35800000,http://www.baidu.com/link?url=Oi74v-cpPp5LE2IsbSbxNbTzC0KC9wdYM36rzxczoKUvU_vpT7KCY4PR1K-cm7bI5GHTcgyejDcNOwwrf4vM3FoONjTLRKdy1MiQH2DGbUG
取艺名,100,26,74,1,384000,http://www.baidu.com/link?url=Ygh6knSVkcVc0rz_UW1JbUef5EFtUkItazZjnxx-oDTADXTX03Z87ichS9gX4pBoO8By_KfAdr0Z07irkCKtCpqvXJ1wAuijKJ4SkV-C9M3
lol战队名字大全,99,17,82,1,13600000,http://www.baidu.com/link?url=xiAsFKxvNlJFmjxhgeUGaz1ofz32co8ABWtoSfwtqtlL4gxm2Fs7zZIFg3PhFRg0QaAMHkMR4gelVVQX2DMTxa
电脑店名字,99,16,83,1,1000000,http://www.baidu.com/link?url=2IHRPwQ6kl_I8kcWn_FzyIlWvEop37_IP6fit2aD1eiWtQ8XgMW6G-bHXwU8K6Ptg60dez8S_cMDgai4eSSe5q
游戏工会名字,98,16,82,1,1560000,http://www.baidu.com/link?url=pzGav7C75H8Yo_b_woiswLU2dsHiTc8pNHc70bvlRI22mUrfBCFjtanuaBVOZvia44-0OEzIvHv6Rm1YQuWMp_
梦见上牙掉了,98,0,98,1,1160000,http://www.baidu.com/link?url=4-IsEoO5pb-rdNBmgmaFd1FnnDQmxXjCHYuWYSB1gaWaDG6A8W2CP-z1QPoiuYPKvzmaYwJT_XQAE2Zc0teJuq
霸气帮派名字,98,26,72,1,823000,http://www.baidu.com/link?url=9C40AoCTrSNIfGCVB3nwTfi2EFNr_8wpHDND2E-kuS32EkR6fAqsHW4KvjZAo0gtBtTTERucqnjIb6nYy4tF0q
广告公司名称,98,26,72,1,6650000,http://www.baidu.com/link?url=6y9FsuZK1OquWT8DzZc0eVmmS7mMFjWd_H8IrQKEbrcwCloROex4tNu90Qm5m-6h2QYpvzbuUx9RXyNYxPgA3q
起英文名字的网站,97,78,19,1,42100000,http://www.baidu.com/link?url=mrtjF0NUt5B-SW8zVH6CBDvpGnUneh1JyXxCP_UZRUJLjg6wnXuLq0GsfoDr-GzlE0eUnubyi9slb-es4nxFkK
好听的男生英文名字,97,26,71,1,3490000,http://www.baidu.com/link?url=YFJfkKuL5NFj2bjBO5eSDgNL1YCRzh9Fr3mXyHSioIFSpD-L_d2By8aDh04t2_gDABtufME4ZgINSJ2_58SeOkG8KlCHXtuMNRnIQu2f6TK
免费起名字男孩,97,69,28,1,11500000,http://www.baidu.com/link?url=vXBkZtFf7oOO17FuEnxEPsvzMb-vs4PhmUCeTALbtVYdIUeXkkr_MopHyLXcfJ2N
周易名字打分,97,27,70,1,2700000,http://www.baidu.com/link?url=9rdoeXil_CPIQo_ipNixZCu3yc3ijCngpRFRsIQJysM6RtDwA6xIwYDIIcs9UzSN
童装店名称,97,0,97,1,2260000,http://www.baidu.com/link?url=acleG89dG-Unbm4DSRMMSEoR9RnDBcxz3tpXBlWxyjRcLbYVB9t_1ZsnCFRrHzWtzFP9UlrU2BVZeJyLHhDkW_
蛋糕店名字大全,97,0,97,1,1840000,http://www.baidu.com/link?url=UvLvHfswXz6n3cxxgUKlHfwXeVPh79yQ84RxAIvAUxdiTpk3nn7iahKM4MApBDfdabGWiKzvkGTcpWmHZXRlpq
陈姓起名,96,17,79,1,766000,http://www.baidu.com/link?url=PD-1GPQxww9v1u7_FApoxuiQCLSW0rKTQ-eiwzRJtjc4zyF-zR5TIj-x4s7bpvPIdpQK6RRl2crxkouSn88jvq
站队名字,96,17,79,1,3880000,http://www.baidu.com/link?url=NbR63XdsR8-MmZPiQPRPepbCKfIASgSKzWIzsvJ5X4FtndQONoGtce-vVVLcw5V32uATJDCNEJQ00N_-LjLmh_
梦见披麻戴孝,96,0,96,1,857000,http://www.baidu.com/link?url=pTKqYJH71nGfOFI-bg61x-WrQ7-bCwkmIFmhh3Qc_JM6E3EXuIMZshsKxEV2h2CH18VspNS0fmek5XhnaXOP9ksZMgNYYzaD7RdWRqv1tNm
起外号,96,17,79,1,2500000,http://www.baidu.com/link?url=hMgpHiF0nP5GU_SKk1nUkM7PPSBw8542xITTgscpLpmS0sZ9KWdVN7ke59oisqikqaitC70_YtthOzuFGEXrua
双胞胎男孩起名,95,26,69,1,2660000,http://www.baidu.com/link?url=Ahm3ymbZS6zeEiQt99Vcb1lC-1smGSpceGAVvdbgCrg1ZTvj4Yb863JpTd6HhiVYyM-OTCh_T3TyU2q1aMS-jDL-LdpTs7fZfFQEgUihFlu
看破红尘的网名,95,8,87,1,216000,http://www.baidu.com/link?url=RFVFpdu1ZyC2kRpHWYw1xfSkbuknf_8UkoahVhFwX97Uo1zyANEWhc0nRZHQ-c_wmyJfi8yRgWau8o99L7I-xs-uYzamlZCtZFpbHz6mNa3
李姓男孩名字大全,94,0,94,1,1730000,http://www.baidu.com/link?url=6tL9y4QWUTE22GCVX5z1ipt9lWjsOQddwdf18X4-SloqyFfxiLUs-VzQWK5xc8Q4Jth-hbcjeXefQaEA-lpySK
问道网名,93,26,67,1,2870000,http://www.baidu.com/link?url=zlHop_LNw1FDF-u_YL5ryaAYK1ni6b4qs1IMm8P2dFopc0NXsbWXM7uTIartCsaLC0X07rhcZJLrqvqHmcspAK
小吃店起名,93,25,68,1,1290000,http://www.baidu.com/link?url=b6Q3FImIIxqUgK0JcROr-dQMvySq1RwKfOEcN3ha2O27F1KbihBPgGM_ah9LvjBspnXz6V8rHbqTKVQlz-rGZK
公司起名字大全,93,57,36,1,2920000,http://www.baidu.com/link?url=sX_UmTr3-67TLuH7YStY7Qb-mU8UTWfYe_duRvdi4JrvWvYPNiE-zdk8_6k_aoKjpJZap500VnE2hKG55ktK__
美容院名称,92,25,67,1,2670000,http://www.baidu.com/link?url=XEx4We9quzoYQVYWvtVr1uYz-9uZa-IzLZmR5mYTd418iQ3E2w0JQdLbkqJp_FSA34Z3rA1yCxLsuv4BTZJ2Uq
熟食店名字,92,0,92,1,1050000,http://www.baidu.com/link?url=eF6NpVZW80gBX6pVeZzPQ-CPdtvj3QLbfLf2DaQSgxES6ROT7T8mZBFYj9-SsN6toM4L94Yt8XVIAsy0tDt4c_
网店起名,91,36,55,1,4250000,http://www.baidu.com/link?url=tGWXWrcQt6tMMVqO4uzo_rY2XAQ5YRTLECVY6-O_Ni11gHiqXxJFOMuhwObC_Xmp4DCzLjXYV61ECgAwiBJtpq
专业取名网,91,73,18,1,2650000,www.yw11.com
测测你名字的含义,91,74,17,1,230000,http://www.baidu.com/link?url=7GikDcUXXg9MNwXLgG1s18C1PQMpvI7A6X519RguJ3ldAVTAXrYFHcA7TgsvsZ3BJuStFNCdHVCgWGVZnU9TxK
起名字免费,91,64,27,1,19200000,http://www.baidu.com/link?url=G6q5mAj5RzJEsGMaaoKgUMMp2GAhi_o5ZybyjHNfmqB26sGaiIDJyKGMUv2PITaE
服装店起名,91,18,73,1,6110000,http://www.baidu.com/link?url=yJKyPHuaFZzTBp2UXZxPQEW_DoLFuNvcNaIalkjIE69acRUNlDl3sPBFW1Hb1kX9tmWQfpYZbjvrxQ54dMn4ca
服装店取名,90,9,81,1,2500000,http://www.baidu.com/link?url=iYVQxStL5qpxFAhsHTG9ReqbQ7DiLIidUlzHcZyyEpoMuuPOGfKBkdnuTFuiRKzoRoZCs3p5UCbSIFnyFAruAa
如何取个好名字,90,8,82,1,37300000,http://www.baidu.com/link?url=Rr1ZR4_8Fcv86QmFp5ODp1Ka8H4_CD5C768T0wudpymAYgFnX1hqAUGiYl07itE2
最好听的男孩名字,90,8,82,1,14800000,http://www.baidu.com/link?url=ryvZ3NzTPMdKylNUhDcD3TWpEqtAbIp77JZ7X8lpDui825D3A7u3Liqv4F2M8-SZ3NHiFw8pfxf7RbjF1bW3csSbomxbPrIYCgUrHG2Nc2q
科技公司取名,90,61,29,1,907000,http://www.baidu.com/link?url=QOsldg-zWY_VjVQP1tvD93QMnUmiJkSJneZqYvTgpKR0TCRKD336ZThv5OI1EvEnhguVeYapV0MCO3FH_DRX3a
起名测名打分,89,0,89,1,2210000,http://www.baidu.com/link?url=bAqNuWnWaw6CkkPSauS6LSFWdcUpDfnS3CKA0IVlpV7aBiqeCiZ3qyyYm-JQ7OQZ
投资公司起名,89,36,53,1,1780000,http://www.baidu.com/link?url=JcTDYqPxPoa5DvK1WjcqaUrSKD6oPgU6cxrQzGzpYpQZ98eENQgQ-AmO1_LroFsf1DS8k1wKd_wCJuyr8EK2Lq
化妆品起名,89,35,54,1,2500000,http://www.baidu.com/link?url=4oA3f8WGsi1irCZEsCAuqzE6pLfYWy4wDda_i1XnISnK6nnkiVmVuTKqDy1ZZXEWqH1OC4kiHP80GYg_ZbSb5K
产品名字,89,52,37,1,18800000,http://www.baidu.com/link?url=XK7SoatQshd4seQ4iSrq7n56FTU6aP3St8_o54XXrkSi5ETkz4u9CbdGpZ5oVdYXDaYrozoLvZTVPNZzcb3Tda
好听的绰号,88,17,71,1,1720000,http://www.baidu.com/link?url=Kv6MdrBIVgdTC0AcIXuOyT97VJeyG5_kO62KzTpi9MhknrjG_ORogjuQAX5NiiW8mE3jHomNCZu5knYr-gG6RK
中国取名网,88,17,71,1,3830000,www.yw11.com
好听的小狗名字,87,0,87,1,6770000,http://www.baidu.com/link?url=6Aj4VbcXZnh5womu9k2HzBb7na5A4uXBvHt4s_hnaFLEoKHRDnPmyAko_LRXe8IGeEE8chDC-FrOCDxZMbRKt_
梦到一群狗,87,0,87,1,139000,http://www.baidu.com/link?url=kh6ADTPZkgspl8j14KP66hyk2qkos6y8p4RQcWxtR-K8unrZz19XLStWuCDWVK_PTP21q3O7W1d2WD9ag4QegK
好的群名,86,9,77,1,8520000,http://www.baidu.com/link?url=wIgUEugzbnAzkHmTRxuwOlvfBvErCIuR3gqMNEWw80xVIHeDMmshe4TUh6FEXi3Ai1Qklk5NKVGMpfEvtcx60a
周易名字测试打分,86,8,78,1,16400000,http://www.baidu.com/link?url=XKg7ETAHyzRJt7DgqA3EgKeIJ7O5ppnTdAKY99D4vw1fExAYerChWym3Zg3UFVQe
好听的饭店名字,86,9,77,1,34600000,http://www.baidu.com/link?url=Dn7FbL7OfC5UtpL2Ge2co5CfQIMvWottDw3XY-XM5k7TCkFJa2WNO_WKSUZk1BXodcNyaun6Nc-ARx4V-muY2K
韩姓名字,85,9,76,1,385000,http://www.baidu.com/link?url=J1DhGhzqlcNWTf9h5wAKsKtH00eU3s_wipN0BqCZmAAJlbzuOlSpjifDkMvOEz4PCVFerlP_GDq8aFdfTOiIbK
湘菜馆取名,85,0,85,1,228000,http://www.baidu.com/link?url=whhDNc4KgFKr_i_gddfEbGzPshes3WhGDCt4oi3zQjxnX9laPinIMhEhvE_SOZJNqYvatyu3KglXpUavFkp5Sq
电脑公司起名,85,17,68,1,4370000,http://www.baidu.com/link?url=VCpTarALe_Ut4zvzXySsPA7m65jxPiA7dy9g-Z4eRFe-hra5xWDgIfBd08lelHtKqA5qWIWaGbeFc0Gn_lJqRK
孩子起名网,84,67,17,1,4360000,www.yw11.com
小男孩的名字,84,0,84,1,17900000,http://www.baidu.com/link?url=XvX_OC4hH3_ltWwBvnD74cnmPXzdgdM0Nz-G0uo_h_2zWcwgQn12Ev6kxA0kUfCMXex7vOKZGZ77A137fWEgDY-Erv9c8y4alUm4hozJDS_
龙凤胎取名,84,1,83,1,3350000,http://www.baidu.com/link?url=y2fQCZuv3GMLaPmR7pdYuHcmzbsAlUbQiF-1fZFiikXleOVK1nmNyN_RIdB-djSYJnBk1bRSZRI7EZkOfzHYIWFUcOa9El06L4jKewWMyYm
免费起名字女孩,84,67,17,1,18000000,http://www.baidu.com/link?url=TVOcNQeDD0WNFd6stlz5X030ZK6MwRmTUYAIEsAxI9xdkEjjHPyHBGp9XSYNxwM3
宝宝免费起名大全,83,66,17,1,25500000,www.yw11.com
好听的工会名字,83,0,83,1,2590000,http://www.baidu.com/link?url=WunhBOY2gi8dMSBd2TRnjAuUtLQNTsbq6qA891IiU79es_KN6ufYAECaT85Sjo7IKTGw0Vh4zBo776nUJSsoYa
免费改名,82,33,49,1,4180000,www.yw11.com
梦到车被偷,82,0,82,1,983000,http://www.baidu.com/link?url=XJA79bBRwXfDvgadklF8mPglB7BTWbb5vBC50Ak_8XdoVnKL-d18Yt4hxDmAs5JkqDXbf6oCyhHCCYa2HkhO1q
在线免费起名,82,35,47,1,4950000,www.yw11.com
取名的网站,82,0,82,1,4940000,www.yw11.com
免费公司起名网,82,46,36,1,655000,http://www.baidu.com/link?url=gB82TH9wyY-h3bwiWg1LRCQ6Yqjr2kDpecwaysVVdj-sJoNDNZLMkAE82aWc-__u
公司免费起名网,82,65,17,1,214000,http://www.baidu.com/link?url=W3jI7KQbKViGq3W9iR3ZsUHr_vzEjIGo9M6q524CgzTox76la8bqziK1bRDVogu0
舞蹈学校名字,82,0,82,1,4970000,http://www.baidu.com/link?url=DquHbgNbb9E7chTiSv16bcwzo59yy2x_foMMTYbhok_qGG4RGLq3e1PMxVLT7HWZdrwu9FJ_pAu1LtwNe82wx_
培训机构名称,82,27,55,1,14600000,http://www.baidu.com/link?url=hgA3KHmVTKIftrE0DCGTFNkJ3tqd1gAZWFl-vxhGr0IgFZlge4P2JtOx_Dx5Syk_r5_ViWBCJaPp2TpMMmE1Wa
梦见穿棉袄,81,0,81,1,93000,http://www.baidu.com/link?url=WUkpEkmQl_aNRij6-8fapvHmzvKPL8IdY7O_Mz-BFSGsortUwW8kWgGxYNM9S-1B5Ap6yNoeZBxQzmXsUb3EF_
梦幻名字大全,81,64,17,1,8080000,http://www.baidu.com/link?url=6RiZaftZuHm0lbFptOlpuBMtsrWOKmjTJHhk_faNpKDXcXESCUZGwRx1tEgEEfk6lfQGhRlUt2LWz-Kfhtnzz1V1oesQORaRtC0VncLl5B_
网站起名,81,64,17,1,6890000,www.yw11.com
测试名字的含义,80,8,72,1,4770000,http://www.baidu.com/link?url=3esIj9SvXmByNPMbHZD51fJO3SA-zyBLesr6zpSLPacs6E5sTcmQZtWCEswL2o8AFAa3WYEZi7IN3zgtDBPVMa
外国女性名字,80,63,17,1,15800000,http://www.baidu.com/link?url=pfg9ZdqXvBzw75V9vZV1_iDStuoMCbZFDuHj955PZGvRnqSF30dirNBq2kfWp5Yx80g1Q2djO8WyDvO1n2rIm6FwiDOrDpcxvIb7edvuqYy
招牌名字,80,9,71,1,3120000,http://www.baidu.com/link?url=YG4QNgwXAAwRpfyLmsQdjOhEU2UZDgP27EmhSPHiPeaq9F0wpxHKfkTzzfj6e8fi7Q-EjI9XlLBOeFaDlRf0PK
好听的群网名,80,0,80,1,10400000,http://www.baidu.com/link?url=dDvEylgDxMMUuVuBgRxsoovQasyTeUJgFWfB1mZPSrg52x2jchVzkWxuZ2ckJLOgQMa9yJnBF3m8sPy6hrgPda_TZ8lZ1AmIoev6jO2yJM7
lol好听的英文名字,80,45,35,1,474000,http://www.baidu.com/link?url=0kIvh8-0Sbv6RJItOOW4XrHs1Cxbnc8Jc3D2Ls9nMDFJCIwimkp-1oZPRsTqVaLJPjBN_PQ2eRUWZQuj7cmhByVjQIPcSt1KYIgD0g6shNm
宝宝取名大师,79,0,79,1,8190000,http://www.baidu.com/link?url=_payor4p0pDw_AIHUnZc1CXLAJhXmsUJP53Ekyt9myq9LCGH6dNDD4GTPOOgNhUT
大话西游网名,79,8,71,1,2470000,http://www.baidu.com/link?url=AVa6Ij26DYO8mg5dFC302jAyUMNAjx4qUGsDehXWug-viPSvZsFfTEm0fWuXzype-rIV4x_hvHWBUA_7bPc7kq
杨姓起名,79,8,71,1,1320000,http://www.baidu.com/link?url=pINnxlu2vAatt8C5a7EO4mManprrS6j0jCwVn3nN0QbFPAUjdCEQzF2NjjBq81IHRddsqnl4CmlG5Vw9zDNJza
炫舞舞团名字,79,53,26,1,1310000,http://www.baidu.com/link?url=ia39LGtdDVN-fbnY28YKJsWAImD4sdqskqfoxBnHIzdtKnuKY7xBnbyNBVbCB_moRGR2PZXjud9VohGqLx1LK9VEvn3ShZrsnFoWfz4Ot-m
电脑取名,79,27,52,1,4040000,http://www.baidu.com/link?url=JSaqSy9rVF7wkq_yqMcdWbGfNJN56VCc4TIsSL2Dycbaz7vY1o_AIbgw9rjHGXSf
男孩英语名字,79,0,79,1,4290000,http://www.baidu.com/link?url=-6WRN5vY48gpY-O7FQhiuHAXjODip9TaLlt9cJO8uYL2dx7IYBFzeK9Dd4nT3qC6IiTBYFRe04We-gJylE2urzyK3zAsGp1OIxsLxSJnhS_
董姓起名,79,8,71,1,352000,http://www.baidu.com/link?url=efAR3UEc1VL-kplj1f9gkRG5douJs1VUZOONP38exYVZ3Dr-Bnt6MqZhfGznjh1uJLo1CRBN9Z0NuEpcEbluy6gl07Ab7ekZRB8oeDv7F5K
免费宝宝取名,78,69,9,1,3580000,www.yw11.com
起名字男孩,78,8,70,1,21300000,www.yw11.com
空间相册名字,77,8,69,1,3850000,http://www.baidu.com/link?url=vMCO-E0_utuzonHcMnZ-xlN-27DlltD5TILVaDQXXc9iQ1bcQiFD6GQVDakwJvUB09mZs5GTQGVXkPZ1dVvWQtR1B-_eYrCBMm1nu5CGWvS
起名字的网站,77,69,8,1,17700000,www.yw11.com
好听的相册名字,77,0,77,1,10300000,http://www.baidu.com/link?url=1-awgECkgEbUwHANokoruZnqpyDr8GYbs3BYnoQWqc26WsV5vp-tQhlafMsyTuZRBJQvzMuaYAPCVBbfxN9zK5z8GGz70HFKivcWwnGiMEq
小名字,77,9,68,1,21700000,http://www.baidu.com/link?url=j4kNKYwiYVzNY3oFiHMMmTt03kFSmuTs1vWbPzFsrQK_Wr7CcehR06UlJLvnpnxM
网络名字大全男孩,77,0,77,1,7020000,http://www.baidu.com/link?url=vkO06BbqB4bGgSUBH2eGpFmd_MFfjoiYiF3Wq1pE8_psVwB1UdUffExODruNXuDhwkgYGqB6SiURMy1AzxrVrquBpb4gD1_cPrMCT09X6Fu
台球厅名字,76,17,59,1,994000,http://www.baidu.com/link?url=XdpebyIZBU-qDOYVN1VeCi6YOuEZqWlw3Q9KZfUkJu3xP9PNUBcEus4ybAA-pAEPu3TBB-Y4G8Z8t6qjZ6vOwK
梦见弃婴,76,9,67,1,12100,http://www.baidu.com/link?url=APWvV3Dw8aZ6WZyreFwIynaZ4I0i8xnkQQkG3SDLuFpxnBqKaeJMJvpSL78IJcBYipuSC9-Xf1KehghklKeqja
宝宝在线取名网,76,67,9,1,1350000,www.yw11.com
狗起名字,76,8,68,1,899000,http://www.baidu.com/link?url=dnI7Jog1CP8XEPjl20NHAvlETbs2__sWpbS1jfhGrEAHbvC4879OZHZQj4tuQlBv6YcpoUPhXIiuzecGboXaHa
蛋糕店的名字,76,8,68,1,1400000,http://www.baidu.com/link?url=67YzttPvFziZodNx5E1XnSmhkAwF6_IA9YsHHV5yWIGEp5yQ2qd8CwVtPwhCuA-2lrnPerHb5ZyduqwFtATfmK
食品店名,76,9,67,1,3280000,http://www.baidu.com/link?url=JcGNI8vi0jMGl_FzHnJM6lU8k8Sf2uDJ6Bc-qBzH53TZd1ZuE0PNN76upOym5VUqHIkDvVNSmdEXebt8gnfa1q
给男宝宝取名字,76,0,76,1,1670000,http://www.baidu.com/link?url=zK-uNZYkatnrDGlklU4KmG1InZ0ewl356MnCU82ei1bH5jiemUcsESf_ZGl_qoZ5wNy4wV3MV5nKnXzGmEbT0qnWzjloW2irkEY8cycBk5i
男孩好听名字,75,0,75,1,12400000,http://www.baidu.com/link?url=B-DDicMgLiw0hqF2vn-t3bgRYJPKDdbBv-Ix6_wC--erwCwGMUgOYFCK3JUMkSDeiMGQ0HRlZMg4vQ36f313Nb6E5z5sEUV9MJ2r4_XSndW
女孩名子,75,0,75,1,21500000,http://www.baidu.com/link?url=GP97FKGDFAW7Q4uqpfrgzugJwW0welfsZ2EdaxA5TkYSU7YEpD8EE2ETbbICYXCy91ltXsH2euFXfZOeKkIbEgOsKhzi7K6mWpDDHz-ZIwa
免费宝宝取名大全,75,66,9,1,3720000,www.yw11.com
科学起名,75,8,67,1,4740000,www.yw11.com
免费给孩子起名字,75,66,9,1,47000000,www.yw11.com
梦幻诛仙游戏名字,74,9,65,1,413000,http://www.baidu.com/link?url=7BCIw-USLgmbvOlDc1w2LTl2lmxgE0ZzejTywDn7VD_PIevtK9AETMwSbXfculTLMCT5wIuMDTDvuYMH87Fvr9TCaEG1mSOluXsNuBqVX4i
梦见家人团聚,74,0,74,1,1920000,http://www.baidu.com/link?url=suRXzrmhhFAiP3exsfar_XJuIMT0vjD5kodLKMInMY9LWhdleBahSxCui5eHRagkK1wpVCD4owY2Hf73D1r_Gq
专业起名网,73,47,26,1,3710000,www.yw11.com
名字好不好,73,17,56,1,24600000,http://www.baidu.com/link?url=TLmc_7WN9FPzpXR9FoYTGBq23TEh34CkpKY_AoPdwNEd01Pc_fjNuwBu1Lkj03P-
洋气宝宝名字,73,0,73,1,28900000,http://www.baidu.com/link?url=Pyy5IFnoLXFnjYebfoiqDyh0vtwR1-2q-i_2Oag4VWxIBQp0K5xBiBofe68hX3cS6RpiD_WtGo-TL3PT3TR2Ca
女服装店名,73,0,73,1,1280000,http://www.baidu.com/link?url=YOo0EUHXbEPEEP5A50m-okmpp4xchq1QGALj1REbajaV8oP45ShVei68VjMixCejtWqAM9PdLhqTEW6P66yJsa
羊年宝宝起名大全,73,63,10,1,1970000,http://www.baidu.com/link?url=OUb21J8_K5b6FFXvUFjSlABik8_OU7Po_J2XvM2aVM9x_8BoAQlGEb3AmtV0rYbqxto47nS6WCmSc8aILOboKa
女孩名大全,72,0,72,1,15200000,http://www.baidu.com/link?url=8cRtikuRYWHpCsWGgF8LN0ARGUH1zmxRoOdWGVbPTSh6EAw-kzKQucvndj3C_xG7
许姓女孩起名,72,45,27,1,70100,http://www.baidu.com/link?url=_oJX28WHeJrcg-qiBFjgymEuNUn6uxxdbzMsPXm7wkdZ9BKq4GNPkRGEJITolt5AtGf0jcS-iwbbtZxC0dmGqcYWNU6z2IAMIUH-hpVZ8E7
中国算命大师,72,72,0,1,2430000,http://www.baidu.com/link?url=xWiSNZlW5JCK1OxMULPh0ZtRUWKxqqZlnAEP6KH6l3cR0N4UMLIS3pGcuxnmkLQaFgiJC8ohAZ867u37QK_tia
冯姓起名,72,0,73,1,207000,http://www.baidu.com/link?url=-9DANqSlQeL90VFiBEHrIv2BdE796IP3dx3ZIoCbVHIKZn8bq60BxMldGoliJN7zt_x1i27hONJfATabZv227K
贸易公司取名,72,0,72,1,467000,http://www.baidu.com/link?url=b6NFrjUZVrO_HcH2nzAQuZKPZtrcCFKbVZJ5mCPb5mLLUp2tLR4yKWs7X_e9iPYjX2bPSauddHqJQ_AnPgBTda
男孩名子,71,0,71,1,37500000,http://www.baidu.com/link?url=cXW0eW7i39vB44ZRl6XCDjmoHCFEbQnQzw9DyckuKzavVVbf0pNweupRfOW3-dOoFlXD5sng4udmUPImJ0YYceRImqrY8-zWZjww_qrY_c_
创意的名字,71,7,64,1,5410000,http://www.baidu.com/link?url=dPOYI_SIrDKbSnnYH-4zr12AIVG1BYYvS9A8K1GuGRXY-G2UugKxYTihQzvCKqABsGK4X2Qyo08Py35279y1Pa
童装店起名,71,0,71,1,458000,http://www.baidu.com/link?url=tmiYoV9xcQU7_TILYLmGJ5FSJt8bi00uind19XUwhiLGMoI4r4kq35u5jDO1ZPDg4TtXFHgrQBMxGp2eH4bsf_
英语游戏名字,70,43,27,1,4130000,http://www.baidu.com/link?url=FGp0SYaZigo0_7Oy7MOV2ULOnRm14qKayyxmTTfDi9HoHRXru4z7EAcPVJsv5I3qZN1zS4kRjc0cWQStkOONTeZJWZctin3SyzTkh2-71Ni
好听的餐厅名字,70,44,26,1,29700000,http://www.baidu.com/link?url=pOPJpba39pji2lxJwm4qIhCo99JjZI9r12R1I4RVv4JWd6I0geZ2jCa-VCo8KaGofLJuweB7RZv42HYY9ytlDq
男名字大全,70,8,62,1,17800000,http://www.baidu.com/link?url=DVYhrCQFbb3agSoom1AQviTEObsAckmqWpCACq5srt3BbaNzyTqpW7CXl8fYXDt0yEoO1nW59paZxeJLVmcit4l0KeW-GxJKTYATPO5eFnm
改英文名,70,17,53,1,9900000,http://www.baidu.com/link?url=l497EQL-KYXHcAfGqP720EN0gab7S-PvAM7z39X5IekCVUmIqdLGDkDBf984gFKDsyGDk3LxdmG7b2ZkdeYNqURoc5ed15xTDv4-ch1vj17
梦见领养小孩,69,0,69,1,1830000,http://www.baidu.com/link?url=Ij9CsLBtBL9HBYx8n2UqZciEfZu8HAsTW8BhAxGNdQm0qC2A_AAYsrIGdqokD7X7Ri_uGrzl3fKG7lpXRF2x4a
餐馆取名,69,9,60,1,2690000,http://www.baidu.com/link?url=qn4m6A0q4rZlwlhXgIuwsEghi_0ejq4aAB7wsiWR6hjy7ApC92NZ3WN-KSPJxGBx7lRXQpeZCOZCm-VqFRhSEK
结义名字,69,25,44,1,2500000,http://www.baidu.com/link?url=C1lnCzPgoLvvAhrkukkYKTYgDXoiOU2-xBnpw66bSqWrfTzdCEll82-grLCZSL9b8HLvVL3JR7JHfAkPly40y0HmvmU74b6T5HqDoYsC2k7
按生辰八字免费起名,69,0,69,1,13300000,http://www.baidu.com/link?url=-AEIp0pNIde9n-Lm45n-XR7awfo0gOul8SMGouFiNialLzwSMlKKczlkTironXvd
宝宝免费取名大全,69,69,0,1,24500000,www.yw11.com
免费取名字的网站,69,69,0,1,50500000,www.yw11.com
免费起名字大全,68,68,0,1,48300000,http://www.baidu.com/link?url=I9rqK2L__gGqwmaNlo0ldguanAcRXVYtxi0ufODosGr4Ql4RiztFUacb8gd0lusk
小孩取名网,68,68,0,1,2880000,www.yw11.com
有涵养的名字,68,8,60,1,1280000,http://www.baidu.com/link?url=kCZsbSOrg8QXtLVj8KpZqR4zv0vrvLKSQDedxwa5Y_rjskcBCAm7vxtn6xjk1JdXXPP6Q4XmkGBcklKm-CSwSC4dzyUGd8XjjWF1HRY7KVC
杨姓男孩名字大全,68,0,68,1,168000,http://www.baidu.com/link?url=5aQWK-I-ovrpeWJLFOrsrO23Oi2_lHDi77td47pWObHbRuXwmviSw9IgeHDZIJvqYLSTyl_rcQf1CyJe77Fyw_
免费取名字网站,68,68,0,1,49600000,www.yw11.com
给孩子取名字的网站,68,68,0,1,45900000,www.yw11.com
免费起名网站大全,68,68,0,1,9360000,www.yw11.com
免费起名网站,67,67,0,1,5660000,www.yw11.com
龙之谷游戏名字,67,9,58,1,2950000,http://www.baidu.com/link?url=ra96PYmkI4hWSysG2ixepBf3Kt8VMIZQSJfMHSIZxnKuzDdXObLV8_yhq8OXqv5PHpXcvhF_aqmuupwqs69SNCKMF4v7P-gDi7PbAAHOEv7
给孩子起名字的网站,67,67,0,1,33100000,www.yw11.com
大排档名字,67,8,59,1,2450000,http://www.baidu.com/link?url=e08KPOIaIxmpfbLEaj778qwc_Eebv64ggB6NHhb36RzLB2syQHrxnB6EZGJxgeJM7Bg5b8c69vWl3m6-X6YUk_
婴儿取名网站,67,67,0,1,4890000,www.yw11.com
宝宝免费起名网,67,67,0,1,685000,www.yw11.com
小孩起名字大全,67,67,0,1,33200000,www.yw11.com
好的英文名字,67,26,41,1,19000000,http://www.baidu.com/link?url=bGnbZCkKbjPsdm__ZRaUA-EMSRCZtqyGfKdDfI51CVRowthsgIR6n1vhuhyeCZx-fnbZjmKMdjYOz-tBfz5YOGqOuMr7FMnaW-Kf_mpeLSC
免费取名网站,67,67,0,1,7470000,www.yw11.com
免费起名字网站,67,67,0,1,2190000,www.yw11.com
免费起名字网,66,66,0,1,16300000,www.yw11.com
网上给宝宝起名,66,66,0,1,20300000,www.yw11.com
取名 名网,66,66,0,1,13300000,www.yw11.com
给宝宝起名字的网站,66,66,0,1,23000000,www.yw11.com
周易测名字,66,8,58,1,4950000,http://www.baidu.com/link?url=nJbaA5kjzCzIqFVc9pUMYoeYw70MzawsYF5B6gFtKKvbl0DN4LkHz4RSag7vQ51s
帮派名称,66,9,57,1,4060000,http://www.baidu.com/link?url=zP9vqeHmd3PRl28HZYE45lfNUhoQdF-kxkpaOiQM5IYrGuZibs6QCWfCxwOL_r2NoNVLqhErBczgoG2jSiWfAK
网上公司起名,66,66,0,1,10800000,www.yw11.com
免费婴儿起名网站,66,66,0,1,3570000,www.yw11.com
免费婴儿起名,66,66,0,1,5050000,www.yw11.com
免费婴儿在线起名,66,66,0,1,1390000,www.yw11.com
免费取名字网,66,66,0,1,26000000,www.yw11.com
宝宝起名网站,66,66,0,1,7370000,www.yw11.com
免费给宝宝起名字,66,66,0,1,25000000,www.yw11.com
免费给宝宝取名,66,66,0,1,3010000,www.yw11.com
免费给宝宝起名网,66,66,0,1,15200000,www.yw11.com
男宝宝取名字大全,66,66,0,1,40000000,http://www.baidu.com/link?url=fp7_cJeiFkKAkjxM2NUZ4ebFoqa-zykjujiHGkHw8ZP-HZ_e64dMXNE3r2N-33uFEtdZWIYmm_HuwDALdyuSdP6Qv8fYlb8UckKGQ1MVs2i
宝宝取名网站,66,66,0,1,4560000,www.yw11.com
陈桥兵变解签,66,0,66,1,19200,http://www.baidu.com/link?url=gpqhGCIMf2Jk8aYRhf28905o1IVqIJVuygefBIBhrZSHBd1UfjDGYKeJ6l03gMvcXMEt9wJt29ce4eFO5WaEk6kNt6YAo74lxruSodTMnp7
婴儿在线起名,66,66,0,1,3010000,www.yw11.com
在线取名字网站,66,66,0,1,4030000,www.yw11.com
免费宝宝取名网,66,66,0,1,1390000,www.yw11.com
免费宝宝取名字大全,66,66,0,1,38600000,http://www.baidu.com/link?url=Cm4x7jm4JFJiLSpl4iDnbr3IUoIwtAlp1MGaESmn8uvlefromQGdo8iq6BKxOyqf
在线给小孩起名字,66,66,0,1,694000,www.yw11.com
在线给宝宝起名字,66,66,0,1,30800000,www.yw11.com
免费宝宝在线取名,65,65,0,1,3730000,www.yw11.com
免费为宝宝取名,65,65,0,1,4170000,http://www.baidu.com/link?url=s0NEdtyTCmT207muqqMSnIwe6HuTLOAh0VQzFC-7yQGRYWLfmcT051x1X27kxCZP
在线取名网站,65,65,0,1,2970000,www.yw11.com
在线起名网站,65,65,0,1,9600000,www.yw11.com
英文名子,65,8,57,1,43700000,http://www.baidu.com/link?url=xOVqrT1IskOQkcq58fBo0VjirjVoxE_ObGbnZsUbgeU_MrWO1ST0XDxG82cB7QKS1wXbCQdLlIzecaIl6xDolqjWtVfw-peObsJ5eKVBGN3
怎么给小孩取名,65,65,0,1,14600000,www.yw11.com
宝宝在线起名字网,65,65,0,1,4050000,www.yw11.com
孩子取名网站,65,65,0,1,4270000,www.yw11.com
免费起名字的网站,65,65,0,1,2200000,www.yw11.com
宝宝网上取名,65,65,0,1,3200000,www.yw11.com
新生儿免费取名,65,65,0,1,3150000,www.yw11.com
鞋店名大全,64,0,64,1,70100,http://www.baidu.com/link?url=JL6EQaGmS3bLJSVsETX1xKlekWxx3pRmfZ-pkyA-ouu7d1z5poDAVDo9vawBvR_KyVmlVxNXpbgMnMgQsUJ8pK
刘姓男孩名字大全,64,0,64,1,1220000,http://www.baidu.com/link?url=031449Mn2s5gvbRhn_gqQ-jsH9ry8HCNoC1Jy0QiovfAHqOIVHrHV4mBZqDbWrWxTv0pmqi8K3K-2NKrMhN0Zq
给小孩起名字的网站,64,64,0,1,16500000,www.yw11.com
网上给孩子起名,64,64,0,1,20500000,www.yw11.com
wow名字,64,64,0,1,4400000,http://www.baidu.com/link?url=-2VAW0KlJe7C0doJPisHyxYLSqMiEoRVvRmsEX0jFxBx0AmHFN47Br57lz1Z0ytZfWew3ZV5lyttm5OtITiJna
免费给女宝宝起名字,64,64,0,1,5840000,http://www.baidu.com/link?url=916Pm04Xp2_gNA0LQTOtA4J6yso0Lh4HtlfOODMgbWxPER5IkBB809WSLnj2Q9Kt
免费给男宝宝起名字,64,64,0,1,6340000,www.yw11.com
宝宝免费取名网,64,64,0,1,1260000,www.yw11.com
给宝宝起名网,64,64,0,1,1120000,www.yw11.com
免费婴儿取名,64,64,0,1,3190000,www.yw11.com
宝宝免费起名字,64,64,0,1,2400000,www.yw11.com
婴儿取名网,64,64,0,1,2310000,www.yw11.com
同名同姓的人,64,0,64,1,578000,http://www.baidu.com/link?url=nWcGOKo6Z2qrZpJWxJJMYGQVGPKFQU7pn7zlN4tJ3gER8iVkO5QAVZUt4Q3cKgFB-vTUlTnxdzvR1-CuTg-xR_
给宝宝取个好名字,64,0,64,1,40500000,http://www.baidu.com/link?url=bBx8C5oyYXW7Jpi_78R8A9Dm03rjuK4msfwAyoHSSQcCn0wQI_6fOJlud6SoHiuA
群组名称,63,17,46,1,4140000,http://www.baidu.com/link?url=ueNRaSQtOAQ9xSWw7p1VBbHEdGfsOovpge7iSIWPXK2L7mXeZT3wH4EY61CFleDENxOyvVwZ913D0IjrKg2qnZs0BVXx74g3M2s_hAZigkO
做梦梦见大蟒蛇,63,0,63,1,1380000,http://www.baidu.com/link?url=G55N6cMrCh3KFGHB8aWI8Ts3-Dw4Wm8rmIpNbMrRSJzNwFaWoNW-B_2tMV3MLW1r7qO2ns7SVXLuPTCmMCXh2q
免费给男宝宝取名字,63,63,0,1,4790000,http://www.baidu.com/link?url=W7VofzNQ5Ic7u-XB7XIMiP2v9fJkHX_bLtMrpbPRR5OiKJYW0yDBILj3MTeos-dN
个性的群名,62,16,46,1,1210000,http://www.baidu.com/link?url=ZVuAS7VAHTeIEqtMiI3fyEW7FbJs8GGNRTUTgXvNRNSkhjNBGIwn6wRlNFNR-ysu6RW1zasycs2OztJMm0XS-a
店名吉凶,62,26,36,1,5590000,http://www.baidu.com/link?url=QUZD7Al5HBjzBF0CDmOygtYsw5MAFBzzUdbxEOMgnGgW6w99DazrY1quvajMl6vi5KvfRkt2kOVtzpjKtVTM2K
店名吉凶,62,26,36,1,4810000,http://www.baidu.com/link?url=6XrxIprLkt368V8dX5YDbw5VK8BT7t0fd4YfNYVh5pO40YTHGmjOYbfJlprbPKCftk3dphzUm4GKNFInYtzdpq
传奇网名,62,35,27,1,2690000,http://www.baidu.com/link?url=cNIQ0u-4PSOvzpzPCJ2fgsmL1orUZD4EaN6gZGE9-BxH8A2bwpr0oU5edNHYoS50l2YCGHR9qNuGvjhbaopQS_
房地产公司起名,62,34,28,1,4110000,http://www.baidu.com/link?url=VA7OpQhjWd3q10o4molQi4s1E4Dynh7cRWqIJyAF-XUXCKArmt3b8fCfmJ825pk_euLsW5m_1D1Z_pBhwfaSeK
传奇人物名字,62,62,0,1,3780000,http://www.baidu.com/link?url=JdTNChyHYw3ofPr5jFP973BJGuzV2F4leemQq4gStGRYML6sPMXhLWokqXwzwuogERicXlJnUYfqupQLfozE7a
女婴起名,60,25,35,1,12100000,http://www.baidu.com/link?url=jI9Xd-TVBENyS-ItsrK6pVdkoodnQhhRCoCfMGGmWMQW9hF7mH0qIY5j_DZrnv9gLMjLern3b-FuMpDSP4ukFOGUdxC-iltj45KGosp2lAO
问道游戏名,60,25,35,1,1920000,http://www.baidu.com/link?url=GWNtG6EZi2rs6L9V9dTEK3ro1D4rBRkfnBR1UTnaoi8pBwvqxPxG1bJZp0BuKrfYI-uZMQqtfeAb9jJhJiSh8_
洋气名字,60,0,61,1,3500000,http://www.baidu.com/link?url=mrGnjfWr3TKZr_Hn9YB0_e3GejltyDoTyTZ-KfKkiGWBjfaHqiCmyZx2Xn4N5sxAod6nWCYD5HdHjvc41q6rDZw4UGen4B3ZdItcpOE2a5C
免费起名字测试,60,60,0,1,3310000,www.yw11.com
起名禁忌,60,25,35,1,5860000,http://www.baidu.com/link?url=RufeIvCjf6_kUaE5gEioRk8JleBdI0spkov0fOk3WU2deYA4NDUJcTMHCO_2kBWxMdGSeZq6CwRX-sPP_oQfna
起个英文名字,59,42,17,1,3680000,http://www.baidu.com/link?url=h6ru4nJ_Zx-3jGJEV12RoLrz0c5iAtq7_mGgOxecaikpN7H-aILp3CRrBIzYeQPKCM5PQn7njxDXTIidS-v-SFv45AhzeSAY6OUWihnxHsi
侯姓起名,58,0,58,1,552000,http://www.baidu.com/link?url=RfCwi70CDUKigIUYEDa9-bT0NPlGoxfheTbR0Tp0dsbRo4f-G--7zS3_gOn6TSvogfzhEFOSqG1OzPYG1yiUcQ1TLTro-id9UuP4OzWiGni
免费宝宝起名网,58,58,0,1,1580000,www.yw11.com
康姓起名,57,0,57,1,189000,http://www.baidu.com/link?url=V4AIAK5wki6egczRXMozp5fdIMQ79xM65PkSf_nmLkUK-TnqEPq2SoPFx6CxxsMHqktidOtoIM-X-oJEK4aiT_
空间相册名,57,0,57,1,14400000,http://www.baidu.com/link?url=OSLR3sM6XqxIL5HXgBJkK9M_EFdTiraSbyMImcvJUn27SepiJaYLSmvouLrocPfGNBIXu3rSxdI8XwsrCL8f4nS6y3OU30mSyu-lrxyE5UC
开店取名网,56,9,47,1,1030000,http://www.baidu.com/link?url=Csw-7AaZQ7VkYyJ6SxDIHitMSiT35o_MNEyeNYjIXZIf1w3Xkwft4O-7aIbXZJahuEgScaDfRwJX6jrMs4pI3q
免费宝宝起名字网站,56,56,0,1,31500000,www.yw11.com
好听的名子,56,0,56,1,30700000,http://www.baidu.com/link?url=F7TmbR-9yZhWjf3zYvxS9ivi_kErQEFY7GphGqibiR_tG66cBjXz4XbUBK9Vt6Knkt7yFR9yIeJRAvNzsSp94rawm-mwuJC6tj9STPM-puK
宝宝生辰八字取名,56,9,47,1,8210000,www.yw11.com
宝宝取名测试,55,8,47,1,3390000,www.yw11.com
周易免费起名测名,55,9,46,1,3090000,http://www.baidu.com/link?url=K6w6_tWgukleG5QIzRIDTqrf6kSNG0-ETXv6qAvngVQqapUOHmmKlv3IJmeWNw8n
给宝宝取名字大全,55,55,0,1,39900000,http://www.baidu.com/link?url=xgeBGYldrMTsFQxGJfP9hT89TPE5gkHiFL8uZzb9O0n5D1B4TRVWLn6iCw2Yrpfi
玩具店起名,55,0,55,1,1380000,http://www.baidu.com/link?url=f-xUTh8c44mBUoLSlphm83XLmhzdk1ffsiMhsSkj4d4rwOUsK_hOYl491urID2yliyVFqgmOoSWlxfbW-Akc7_
梦见穿棉衣,55,0,55,1,618000,http://www.baidu.com/link?url=IxlnlIkfWkmtgVZGpjr6Ti_loHW7e40d0_9-88FU5f1pKUEf7FN7U3xGVp867oUMB7G957sgKMWjEzhwNWMKF_
网上取名字,55,0,55,1,10200000,http://www.baidu.com/link?url=OHnDeHIMuFLWqI6Zo4t2SQbk5TP-eN5R1QP9L-IQ0asq03dLTd3Goq0ZFurMxElw
男孩取什么名字,55,0,55,1,24200000,http://www.baidu.com/link?url=Zen9V2ch6IUAX7ZAJ9CZp-iTf6YhKig2JndXNWNfFlthYwIwR6stJgq9zUr1AjxfOl3ZsF8UxpowhtEJ3RePVLyL72-pGJ_n5zMJrk4D3ye
英文名字大全男,54,54,0,1,1370000,http://www.baidu.com/link?url=ZdtSNVmv6tFm-1jZkLmjAnbemUMiVWFbx6fJ7xqtay5ZmK5jTw2wAAejfYrMBA_BgzZKF2Jg54S951hjHugoLFR16rCA8XLRGjAoEcXSfle
好的公司名,54,17,37,1,6510000,http://www.baidu.com/link?url=gxVwJ-RL4U0xhKYLteanJ8f1GC9y7odX-Yf653dzJTE6wojsl29E0YhL9vBUKvz6xAWta3-SLqkzhsc6rn5wma
婴儿免费取名网,54,54,0,1,1650000,www.yw11.com
起名网免费,54,0,54,1,4740000,www.yw11.com
魔兽世界好听的名字,54,54,0,1,3320000,http://www.baidu.com/link?url=Yl9lnYTomwrAeswZM4GtWqZ4BEjoxTJO2v2hs5_rZ7yAN3CrCm0WH3UyBfXaQ6McNqjr4fYB_ZLKwxIPVYjEIq
好听的名字 男孩,54,54,0,1,9230000,http://www.baidu.com/link?url=9rEBmjCYLEpLmKQNb_0SpeMsyoCut8B0xUM6c0c_OJc2gKZhzC4o5xwsriOecLFntgy0QCIbvXViLcduK0kMgFxAmGHaNj3cWcFAks1TePq
蛇年宝宝取名,54,0,54,1,1520000,http://www.baidu.com/link?url=a13Na4rA8-0tZuR0jxRCJ4yKC24sL18UW52seVn92Sw9ZqjmmKofyioS27pVhCrkP9twB8KueC-5vKvweMVIYa
百家姓起名,53,17,36,1,3930000,http://www.baidu.com/link?url=Sht1EB_hrWghSEPzyPQCkBU828l29QPinSqGXiYfwSzLuWlRjhxOvwo2eEE6lquV
孙姓女宝宝起名,53,0,53,1,730000,http://www.baidu.com/link?url=TjWZU_B1vZip1L7hjqy4nKBeMy8dGOrdjYVLrqRkMu05i0UkREoqvBdq1krbI5Cm9aIckoh_V-n8FEGVhcVv3q
dnf公会名字,53,53,0,1,1080000,http://www.baidu.com/link?url=mN6PMWdI7TwCKtMc1K0aE96JCjvqG2ffekhPzvWOY3aeTS7qnalSp8pm7i8bL2RaUDkYos8a-1A4MbmYXXxczRhNmoQMR5jyFQwfZRzHiHY95uf40Yt-QEzKmWsEyvd5
五金店名,53,0,54,1,1780000,http://www.baidu.com/link?url=S8TMWXnSj3OyWaS9yXmMEN1_ar_mj_QcFbLelsZ0uvrext_5AGtAyKdGW7ZxnfKcTv8KHdP2vECjDr2nK5VnB_
文具店起名,53,8,45,1,2340000,http://www.baidu.com/link?url=prIEPL2I71y5mMW9BrGCWP7ON6A5Lk67OaAOcUkE2yCF5j7_QDnSeGXDIVk0GGqpkERHUh-khjUZaliVYkKDAq
魔兽世界网名,53,35,18,1,3590000,http://www.baidu.com/link?url=OEmXXGbRuru9NVZ1OogU-Mv43OXf36-dTLhgl0iFq3Mi7Hd1Ttz3JqftGx44XQZtvwKMqIBDS6WPBvvxxCjv_QLL_QzZavXVdmTS-Frnxg3
合作社起名,53,8,45,1,855000,http://www.baidu.com/link?url=WTwJRkG4gF-McQgIiUnhHACbkSBijqTr9EcqAR9OdDyCc7VFyiySrqUo9rzy7fQNIpuaLJUQloP_hKP_YwSIkK
马年宝宝起名大全,53,8,45,1,2680000,http://www.baidu.com/link?url=4JvPElSs3Gw3FoU72P3CUy5gImPJPji1gFzh_8pkefTApaiIyavj_zDbgNwxLtIsXyuvyPTfAdXN9uCSpt9ztq
最好听的英文名字,52,0,53,1,4700000,http://www.baidu.com/link?url=WHUG4MdkXYs_xTsvPJpFKjoTS-1c3l1P1unAoBFZSxIR-fR4nMp9Pcku8FOgqC9Igw4-7GFHwy2ISMGgzTIlQZ2aQiDVn2rnqdZU6N3fm3q
公司 起名,52,52,0,1,6660000,http://www.baidu.com/link?url=nuW3Hy80Vb0JVvImloUY_xb4AhARaN5yF5FlscQ-JumKsAJdHzuHooqTHprf_8Ob
传奇霸气名字,52,43,9,1,2720000,http://www.baidu.com/link?url=oP1njFju54UwlkXnNhzqQE7gw1PA6lLPDQz__9XUbRUosdFmGeuYiXhbEv3Bki5ZTgxscwEU--yaPFIpGtn18K
游戏英语名字,52,17,35,1,39800000,http://www.baidu.com/link?url=rMgQUmm2F8Z6EQgI4IVjcRZEsElia7C6ABsiHhtTzO00kiGVMpvv0-_LM375afHsJEgcVBF18kJnawqnMlHcELlCxIaMp5DI9iyiwXGHaOu
起名 打分,52,34,18,1,10400000,www.yw11.com
在线起名软件,52,52,0,1,3790000,http://www.baidu.com/link?url=pTxfGRixQmIfBfxnZEVjDObq2ZeC4OzYV9HA8oaenMCrhNPMJg_OPBqFpMrkXX0P
取英语名字,52,8,44,1,11000000,http://www.baidu.com/link?url=YFPTsLmZLqY52AoQQnfENquED-mi99bGOraWNgOyAlq1yoLLPGvD_X8rrepwzSaEyshxoilMwymo1zjBnIeMDBXIS5_gG2kFDVY3EwHCTmO
取名网免费测名,52,52,0,1,1630000,www.yw11.com
女性的名字,52,34,18,1,26100000,http://www.baidu.com/link?url=f-cmfURKFowuDzD4jl8fXxSXBD0TjeJ0X-v5NQbGjB8vMBbLavhI2v7hJjA7ry3QaD8UoTlYwD6cEUXjfIL_XoEzmdAJkHgFrSo8MWuCjke
魔域名字,51,42,9,1,2970000,http://www.baidu.com/link?url=2CObX2TytsMgJYrwqwMFg7OH3jV6HUYMg70GcY0rSWSCi_ipk3-MWFEO6lzTupgHM-ZfG2DlYoraZOjA9AkVf_
好听的男性名字,51,34,17,1,37800000,http://www.baidu.com/link?url=sMilQzswi_8PbkrkbsKdOJV8akVQhKye5yhkjx7ecytbIgUZ7HdAndmOmqal2_hzV0-8BxQ4vqF5ESM0ptIExU0znh3c9stEPIB6fLgvNaq
dnf工会名字,51,43,8,1,3850000,http://www.baidu.com/link?url=RlCQjLO6AgGqdQAxh_uzwSBM68JTFKG5MvAkodjDkLw4qhNKe9D6Hn6zcHAt4kCSIYamrZLMN63dHds0X_Sov6cLJpJJOYraYDNu7flrzzkopW5BlGYLy_v49VDbemH-
洋气的狗名字,51,34,17,1,16100000,http://www.baidu.com/link?url=nX_uaO7Q2YDBvpuTkeJv4QSpC4z8xqLTeH7AOkyaCYAP_SEme49lkwIxLmYE4ZXkKIaOeeEzvMpoa5Zn75WFgK
杨姓女孩名字大全,50,50,0,1,119000,http://www.baidu.com/link?url=piveOBbqZ5FNTlXSYQctmVt7SA5vXhcmM9rCOuYrLlkJoIa5m4OtBhlo2CsMV5QzZSxsNEtXn3W5i3Ea3RFKaq
好听的女孩名字大全,49,0,49,1,13500000,http://www.baidu.com/link?url=ia8vJ7eBArp83jZJu2vo4o-s-LWdsYE6YzWhh56MIb6qMDAWMFZBJZRc2TQ1fQEWXtneZdsG0QEJ1FzaeOYZ-_H8-tDNZwEn0viYYPu9Or_
段姓起名,47,0,47,1,404000,http://www.baidu.com/link?url=MBmEzuGUYK4sVIvob_CVmnsNJFu7Ww8sq1udLqAm2N6YHknYxtGKUb_j1pVrfUiZxTCcGvGnFacEzE5snNPqOq
公司起名网站,46,25,21,1,10300000,http://www.baidu.com/link?url=iz8XrIPEbl-NiURHiJ3BL9nFNwxcHyiMl6Sb66TMEqVx-v_nR7nz9MAz-HX3XzlN
问道名字大全,46,26,20,1,1620000,http://www.baidu.com/link?url=ivKf9bS25gDs7KDDrtfDlgkbBNs69208cKxpW8Ok9lWlmlC1z-maCAULzzQ60SjyM_tGcxUhq5ICmiAeGCtYMK
蛇宝宝起名,45,0,46,1,9740000,http://www.baidu.com/link?url=PuexiTWugChGL8FNvYR-KlfYbu6m2yYScc-tdr9Xy2xhfKU6fzf1fcsaPotZuA3umi7lxtVmJY8Tb2LbTc886_
传奇私服个性名字,45,45,0,1,314000,http://www.baidu.com/link?url=iXj1P7J0jNAbo3hFl1J8Fmdhyd8zlvOBaLWYKEgV5TbUz1ymafrrZv08nOS_Bwb09RVL7VjOi-uo6LJ1y38v2q
婴儿姓名大全,45,0,45,1,3380000,www.yw11.com
男的英文名字,45,28,17,1,9540000,http://www.baidu.com/link?url=dqe2zTouHopbd8b3-pg1r1Dl8xfB9xOE8SjWO0Ci5CWEhzFzQZAYi1UcKs4Pmd-iRXv5MNvm12RfqR9aq2V7sxcWCW_LQZqXIYK9cgZrDz3
程姓起名,45,36,9,1,178000,http://www.baidu.com/link?url=Kvkr6emBkVZ73Qp8q0ZJSYdMlcrZzcSLQoEtQRz2mZvo79vuTPVSjivw2Cgk6qAhGHJak6kMy-0Uu3tTjheOip9cg7Y6z2a1Xi07lKuu7wm
qq炫舞名字女,45,45,0,1,1590000,http://www.baidu.com/link?url=ZeM13TUuBtJLcsL6WvprAk2lovJWmLO3urWE-8mUeKtLrSjwcfXdXx4Xr9bHQAYXwACcSMWBVnO9dXUPZeJq3_
取名测名,45,8,37,1,12200000,www.yw11.com
美发名字,44,0,45,1,2990000,http://www.baidu.com/link?url=Ducnt_ij_SqonxK4-y8vDR_m3xKIFHyeSNNKPBjyFsoTLPyaC4vya0ccTFZjK7DrDlxu2vCH-dDzop_o_Xd0Gq
起名方法,44,17,27,1,10200000,http://www.baidu.com/link?url=sxJB7HFNlJKiDlAevWp5Bbf-GU96Hu-WtKrhgRzLLWxd4J1i00FVJ7ePCfQoDEe8bPoiACIoaM7zv83fIFfU0_
带土字旁的名字,44,8,36,1,825000,http://www.baidu.com/link?url=OLf-Lcuu_R-WHbi_nc1PEr1u0AAU9FdlNEAKhzzSfAUXkBbkyQ3DUOCgNHjCBjtNwubAynecae544_XkheqS94IjUjPm6zGYHjnAEhmFLv3
免费公司起名大全,44,36,8,1,22200000,http://www.baidu.com/link?url=ksUPagSF5c1H3GmukbwENyUqNXb3Mjfai4EcL1AxzXsYeZA1hzbxWmYWcnLkf8Hf
冷饮店名,44,8,36,1,646000,http://www.baidu.com/link?url=hsg7pZ1mQM3xwzd9eEsw_wdXxkZgCkTbM63P5wFa2P392W2ABibzhM0tmWN1pH7o2iQczOhW8ZZft0VxwVqqga
辅导班起名,44,8,36,1,1880000,http://www.baidu.com/link?url=XlZUekNM6VUX096B9sZpjCjGzeMCDaOqIvQB8CCQ0RyYrgvZIMWkeZ69I2MY6b7Ic9r0HuDlMUgn8EjM1cBDDK
英文名字大全女,44,36,8,1,2440000,http://www.baidu.com/link?url=9mx6jLqjgxSSAzzWbHdl3oS79RWus0BlQdhGrmBPJ0eybconX75mE7_v_x3kYdxKVN-2n3hxY1kvBFrzhMGbxa5iFPj_0y8oMZ8lx_ia3nG
姜姓女孩起名,44,35,9,1,34400,http://www.baidu.com/link?url=Z7rbgsg4JAj0WPWEXLCklX8jVFnIh8hGg-9xyOpc7YBQJmiRk3VpBNlpTE01kX7xs2CMFQDI01oj_Zgryp9SG-NqPUlOGVnI8XlwWpl9TAK
软件公司起名,44,44,0,1,3890000,http://www.baidu.com/link?url=0uLXbFMqG8VISnlNamDXLGeS7wCsJbtSJWSvpyxbUygGEXZuYnSLQkDcgQsnTqDDRZ_NndNwtZSpTV017t9khq
婴儿姓名,44,0,44,1,8850000,www.yw11.com
陈姓男宝宝取名,43,34,9,1,748000,http://www.baidu.com/link?url=afpEWlIRB52TnFKz_O3U_PjaSs6mAS7nsUDigcX6hjhK706cdgoZ3OJbOqbWfGZ_kCFEzQcrNUiVIpWExXSKdq
起名 免费,43,25,18,1,9510000,www.yw11.com
梁姓女孩起名,43,35,8,1,89500,http://www.baidu.com/link?url=j4ssy791bMGWCG8-U0x3eISNfLbou9WDGB9VzgWKR3Z7MVda2pASs8xKwxC5VJ1-gM2FerseZqUxmG6KjohpYQmxBBwZcc_Fb-7sZjyPt3G
周易取名打分,42,34,8,1,7090000,http://www.baidu.com/link?url=ugEdjXEdsvBCsguOAYkVs-8kRzRpNpbyYvwRFDGvJ_qSYiLA9wPQkBh3WbNQ6B4T
梦见红白喜事,42,0,42,1,3310,http://www.baidu.com/link?url=dd2_lNQ4hzX8lWoElFDZAaqz7GlCYIUNgCIxjWvuP-nEbLTg4fTzDvpFGwNWwtNlEIH8wt1Ng9ieCA7cf6Ji0q
魔兽名字大全,42,42,0,1,2420000,http://www.baidu.com/link?url=xvIwwn7WROnZdGchDVCAN7FmEoChMHGnwPmL0JZt0My8ftv2988U7YPJydP6evD83wiUO59jUnjkaVX7exyzPq
火锅店取名,42,16,26,1,1050000,http://www.baidu.com/link?url=QV5-OU3jDZXZyldxYB-4vt7PO8K3qLijmMcYhV92EqAXTXob023F2XJUkgbS-HaY7IKXMcSct546iY_FigC7Wq
yy公会名字,41,33,8,1,1440000,http://www.baidu.com/link?url=RU-p-FP2R5Q6vSginj9ifUO8DZ33tcYKvxsqhIv07KvXwSQHpQlXt6JD1HDpOtJTiZq_sz1ZZOuJvcyL2hg8Zgp1-QIg-4BeN0cyNKqYtBe
取英文名网站,41,41,0,1,1370000,http://www.baidu.com/link?url=OBTQsWRzScz81vcrdyH7ANY5n9RjMchCNI11e5mVKyREBoJHRmaf7voj63NFYZ0GepKw8OvbJZRjDMZQpRHDwkEWtlTC_lhEVC6fZyzljsy
好听的女性英文名字,41,33,8,1,10200000,http://www.baidu.com/link?url=uRre3sZo70GSVSlsK-e7gcIOyeKi7cayIdegrOaWkrSfxpMo6FZ1R54uWEfvOq4QVgH5r79w8aP3TI5luRxCWLniWxuEnaJD7rtweFyFjlW
服装取名,37,28,9,1,4000000,http://www.baidu.com/link?url=Za3-K5korP2sVb8MQuKgWdlI4BtixIC5En5n12B2NTg8ajsrE-oTtm-FQ1a5C-Xet8IPc6SfKcwgmNpkRspW-_
薛姓起名,36,0,36,1,765000,http://www.baidu.com/link?url=6DKt2O90DI76g9fevejfRy1wDOkKYAz47ISS-luWVSvjpHXUpLftcYJ9MxHHAGF-YQOV_4t9nWA29BXbW5eGRq
养殖场起名,36,0,36,1,2220000,http://www.baidu.com/link?url=sg4T2NkLyKALBGQT9pYNxQ7qXK4-Lk6i0B6Rs6Diy_pYSWd8NZKOtb2C6acuy9BmjIRTtWGGZ39AdEy3cLeE2a
班级群名字,36,0,36,1,3920000,http://www.baidu.com/link?url=pyI3yT8o2d1zqtcZ4i-FrH--MhUY4ywl8tL7XBHZG7E9m7WFq2gopRt5BDeDYQ2jY9bIkEc29a-M3ZdV2v72X3UdNY6z9Fl2K051n-OrBAK
蛇年宝宝名字大全,35,0,35,1,2610000,http://www.baidu.com/link?url=Q4dUsx5ciG4Smp5u4E8u1lHe-DfeujO8vNWMSsAqG1YM8bLataeWSzh0_hJg5QR_iJtteDiRnOVmYIGcbVtMDa
起好名字,35,8,27,1,5690000,http://www.baidu.com/link?url=jfUpUSwODDBAyK8j7kCeDtYUufJfOxGUW-2MCCjPrL3cAEDfwWCgdhltEelo2V5bU8v-kafa8VIxsQxJdKL8-38T-Lr4G-B1jh4TCvadw2W
yy频道名字大全,35,35,0,1,1850000,http://www.baidu.com/link?url=Tsfk4DqQPJ0KX69ZYx9odUBCv9xZ-JizjV-Y0ntgYQAtG_0nWtNlLeI-Tim6bWUV819TR06o8FgAGULF0d5rxDrCqPLZ9MRlYmRKWtpb-OW
张姓男孩名,35,17,18,1,405000,http://www.baidu.com/link?url=-oHOBUH6IxI3vLyMZTdWQonyvqD2NjMm6ISrXVJ2WUL10sMPAP6CE7Ww3JTB6FVkI5QeHcBFwt_-M3z1dBu5T_
御龙在天名字大全,35,26,9,1,725000,http://www.baidu.com/link?url=7h_6-wkIFGoO2615L4wjJAPF7BLS1aEscDRlrkohHsCDiuhNKfNUiu7X_2aebNcX7clj1_RrbbMR9elmsq8QKq
最酷的英文名,35,26,9,1,421000,http://www.baidu.com/link?url=GK6pcj8PT3yVnLhoNb51CJWUwP1OJ03h4xmOSYkQmjGETsZsplBNBGdAVFdbim9TU_i74bviNrFgbovlot6DLZGA5EXyhJVK6WTSQHwfXbW
篮球名字,35,0,35,1,6930000,http://www.baidu.com/link?url=_65BoK_FYTA0mZB7pVWRNQwgyNpUVXc7GHVQoWn8UYqT9Za3Sa-opJZla2Di6e-1MPucY5xlUxoQGtew1FRwfq
免费起名测名,35,0,35,1,3590000,www.yw11.com
药店取名,35,8,27,1,2160000,http://www.baidu.com/link?url=Wxx4HrhPJs3v78RffNJQRMfrGovZ3XRrHTTwlDUiijrSIvBqYRv9pxsmxgc2S-jg4krjTu51-MimGibzCwgJJ_
女孩起名字大全2013,35,0,35,1,7610000,http://www.baidu.com/link?url=QuP2jojy5fd4HLaRrXbawdTalQFga3Ras1Oe81jY4e2a3uP_ItyYwP5tXRnO4gK3O0Rr2IzMH0NcQT7kGzVO6I6tWcxAiQMgds0L0NV-ADG
结义称号,35,0,35,1,1360000,http://www.baidu.com/link?url=Cs7EQiqJFYadYsHlKtH6DACMrFCB9SuazmFjQkWCSxMm1sNQ8P4iaDbR0oQlyoPFr0x-YvS2Z9slgfE6PC0n0Lsu8RIEgfWPbXpH_SDUn3a
舞团名,35,8,27,1,118000,http://www.baidu.com/link?url=6zX-WdJGSU9QgLYRNlldBq5W5Qx6GD0kW9PZInCYiA-PxShV1pDUE90W63C-5Q5hmbWKLQpWN3BUGVh4M7xRHv0de0E7RDLHzHJUhd6Q92q
舞团名称,35,9,26,1,1880000,http://www.baidu.com/link?url=hWReHNZp_IQHdOA2hR29h8PGlcM3RgpjGZu1-1UWZaLnd7DLgQ8Kwt6u1CA6ktIBzYqvnOauBZva7XB7H0AAOsAavRx_qcFFA8LUborvawy
网上起名字,34,8,26,1,6770000,http://www.baidu.com/link?url=fJKL_Eo5hdGojfBzE-Nd_mvHf2OtdE1OqPTookIYxu0GCEaRWQGamAI8pVjyxLL_
好名大全,34,34,0,1,17300000,http://www.baidu.com/link?url=9tMyrrKu5dud0xQGqKi-lCLDWefwU5X0N3mnxL26nJuik6VuAGT-zyJ5niBB8crR
饰品店名大全,34,34,0,1,339000,http://www.baidu.com/link?url=CGHlZyQzHhARtAZSelhjp3ZMCL_FujrW9afE3ppwk97C03agtlNpfrWfU1Ke7brqx1Bf2D-MdC5pVMpDlijXRa
dnf游戏名字大全,34,25,9,1,4100000,http://www.baidu.com/link?url=gizjce_2N2uIgn4tA3mN4LVmGdwZzc778d6wSMJS5QS1SwSbPg57eODYVr5bo18YYv0WW6kcogSjVLFGlhUwSa
理发店的名字,34,0,34,1,3360000,http://www.baidu.com/link?url=xbVc98w0Zb665BH3OktrBpJuAmOoysVuin8s-03y1vfXQmGezqZ4mfVlVAilHwAZoE-K9QVh-NfbjlWyhSzK_q
生肖起名,34,16,18,1,19900000,http://www.baidu.com/link?url=WtNOI1ojokVsXT3LiWmCRogf3MM2AhFtO8-vJLEiSVpjWJ-OwgOJPTlqDp2fml9Qp5TUcFU-6khy3YWVhFw6aq
歪歪频道名字,34,34,0,1,2410000,http://www.baidu.com/link?url=Hfx-FhfdpjzGHgKNLj0cwNUklbA4YxnB4saeepCciOTzGXj2i2-Cdfs1hdep3cqgVzkWw4rwOIPKT4rPjr5c5yBjHKIvhVcq1WmF-YhyBt7
复姓名字大全,34,25,9,1,1580000,http://www.baidu.com/link?url=We4v0_vWd1mXyxaorPT2mC0K5nzlrJo02-bx2C8sM99d3f0M2VN-7dDer3ubeSqPkU_UxZwnrXl_pgUAPy7Plq
好听的帮派名,34,17,17,1,1230000,http://www.baidu.com/link?url=I2l03IMu_H1ir5a0XyaOg3hgsmqrZ4zBLNw3vwDYQ83E6-nwiJyio4u8ca7Z9BgadpidYl4AtLvkJKcpxhBYu_
好听的团名,34,8,26,1,350000,http://www.baidu.com/link?url=lN8CgV_rnIyMfGU4u7UGGKGCnJIJ3lyKn8WeZ8IBxd7Wdly3qXM888rIo6wPmN__T1AY583sg2m8_CjSzMfet7G5afnq2zKory3gE7-NbWi
qq炫舞舞团名字,34,26,8,1,1130000,http://www.baidu.com/link?url=_6LSLvNaZY2Dy5NfV23CeTz5gtc9i0bnRyb1gU_KalbCNROBzL5LHObEmhLcVPbxcqsiQcPWaO7rHIciEtkMHS16WqY9Ff-q_9IxuNobhte
外贸公司名称,34,25,9,1,17500000,http://www.baidu.com/link?url=NpHYcQhNUYhKTTO-wxaUpQDydMBa0aeJkRuA7XthsdzjjTnQqm6p4jpcvY_MQm6vkZlhh9sQ9D8XMwlrYGSD6K
化妆品店起名,34,16,18,1,1200000,http://www.baidu.com/link?url=rWbKsbeJI-fUXx962cuZhfSitzSWvmCr6MPJqzmHxEWcwWgz0qh5M9Lc2Ya8s9KUENrJ3oAQ_Wt5VM1YUkUe0_
取名的学问,34,26,8,1,5850000,http://www.baidu.com/link?url=8rJ6z5c4sXnvS1pN4-7V7fwBroz2k9jt02W4hykcm0TkO2BNtYJIIywIyPY1Klm2CI-puyKQO-d19FyZ6eDtW_
网游家族名字大全,34,26,8,1,19600000,http://www.baidu.com/link?url=jS4lG7fL9BSeUjyQA3hl0cpsVKHDhgoxvzbuDx3khbGBTsEKrz2qvjAhxZoBYiRub0zceet0gTqcRy-enNtvWa
流行英文名,34,9,25,1,7110000,http://www.baidu.com/link?url=lQBBozMrKNsLs3RGZmbQLskv7GPvZcm3fFmLqvTzUfno9wqqcslnokQ3z25lhK_rBTwBAyZpja2Mt12LTrVd3yDKr5zXcDbSFIm24i_YeZW
邹姓女孩取名,34,8,26,1,70800,http://www.baidu.com/link?url=-U4EH7b3USrpG7OuTZy5h7RAyAgp6009FLNQE0GplY1DMpCNGnlfHYK_YpenWAmLiewDxX8g2X8Gj-6FL6gyLb78BSsHpT4RhFeZX6dgdkO
餐馆起名,34,17,17,1,2300000,http://www.baidu.com/link?url=N7ebMJ5fYKsL7Kpy4dcQu3oHeb7cny1MtjhGduGHyN2F1AZ3LMOqJwBiO1j7qbcuwsUBUAWT_wiJv6L9aGk1qa
周易起名字,34,8,26,1,518000,http://www.baidu.com/link?url=8x4RFYG4uYmy-Iew_X2XRTVqZLkfWKztzKnsyTs59WpcVZ7gishmiECkDajYqjGq
在线公司起名,33,33,0,1,1360000,http://www.baidu.com/link?url=r48F7-PNt0xRHNF6fpW9Y2iv0As2M5RBpzqxI3lhnibMOaomKAebSzDOr5kq79Ew
炫舞团名,33,25,8,1,450000,http://www.baidu.com/link?url=ykMVZ2jIEef94np1AAefz41n7_sb7-04oy9lWd_-5ChAA_hxKNmoN6ADeqwycdnmPP44-Jka1GtZYKTCAICA-hoMgP5mWUTE4UEsMuR9j6S
洋气的公司名字,33,25,8,1,4820000,http://www.baidu.com/link?url=LrJBEwNPs34gHWdKhpJt_0Udt7f9gRW4xCTZ3bgMNgvFgIFHo3hBOF6uvSM3Ia_VkWWtxSUMmTVEifJ1nu2OaK
热血传奇游戏名字,33,25,8,1,3520000,http://www.baidu.com/link?url=3B_BhO7cvBhfOlta92wBrdjiKOKIsIb4iiAvI-5j99v40jeoVjL2B0B_gHyPIxyvF3q1sbQ5srtLFgy9ooIG_a
取什么名好,33,33,0,1,9170000,http://www.baidu.com/link?url=We9bsylHlt3uABij6kra4-0Ao7jjaK9-KG5HVmpEljZTNteCCsOB3Bx4OtfJAFABQkoHJ-X1_nnW9fltzBH9JP-LpII5XtDPDRA92AwrYLG
游戏公会名字大全,33,25,8,1,636000,http://www.baidu.com/link?url=_FHgfCgJnDwzExXorSw4KsrSNmWiaNt3OiYdtZX6ps1v1-bf-YVpforZdWx3J0reXL8SOSmUDrO7aZv9vBXGPq
姓刘起名,28,0,28,1,2220000,http://www.baidu.com/link?url=TFBquD0YOGKUdhTXoPUJQ1bqf1VD7BBrYm-ZyPU3Me8g-fzggyzVbVtitJPqEkWCo_o1YJNn48j06yeRE5W60a
杂志名称,27,19,8,1,6130000,http://www.baidu.com/link?url=LlTvrhPYHyh4yPgH5SpgWySVI7RPtzYi97VuOh3n0zVUacNNL23iVPhV9-4BWF4WQHj92YILH7X-nCbLQSLC2a
男孩叫什么名字,27,9,18,1,17700000,http://www.baidu.com/link?url=5lf4NXcXfTJaR7jmUflTMzzClwAn-NsnOGs8K5SpTwzO3BO73rxjVPCJP8Sk6VP28H1DPQvkzEB-iTAmXmR0vaC-nflICKZvPufqI6L_LFe
女孩的名,27,0,27,1,34800000,http://www.baidu.com/link?url=ZFrOSQa3DPTpSvLSRXcGhj3TaqYY4leIKkrpKWe2036o8HLKL3lkLur24qOEYgeagh5lUzPNdAPRZ0qwaI4G-PUbQ4sMoU-YrJCfnwDT6iK
霸气公会名字,27,19,8,1,1520000,http://www.baidu.com/link?url=dBjMoUbehbr1MYviE2j7_W98_iEkTYfmH8Ld-qNnus5MeE6IaeoKkmLgtuw7MECetmYfpXGvTUR7yfovxBLYYa
商行起名,27,8,19,1,2180000,http://www.baidu.com/link?url=2d5Nw_mR0a3dOCmRFSblWP5vnLH2WkTaBptHhMAKtYiKE-Szh_Vlv6l1bezw5Cxau1wROnNtc4nH_BcRSv4GRq
起名测名网,26,0,26,1,4230000,www.yw11.com
范姓起名,26,0,26,1,182000,http://www.baidu.com/link?url=Ymbz0Tzz7VdhIeo18Ef5efZs8Y92o6i1fmgLWKfdxpO5lkvOhkwZS9aoGxGk7qqdEzcMPjFQaAHZtqM5SOvS6K
深度网名,26,0,26,1,3090000,http://www.baidu.com/link?url=XGO5o6Q-vI7IpkyaTvmq38T8Bl5iY9pvPkLcqGdlnWN5ZrSUcYrBxj9Za6HH67jnmbDsTP2MMoetajEb2NgW4q
在线起名网,26,18,8,1,4120000,www.yw11.com
在线取网名,26,0,26,1,3850000,http://www.baidu.com/link?url=zc21Yw6mD4yE-b-yziR4tmuaw5QLsghUvR_pWHLzZknydfHQEikwuxbVar7ws-AK
免费测店名,26,0,27,1,7450000,http://www.baidu.com/link?url=nn6RYVcROnt8JAEFZ8gW_nSC1pugVxi8a5p43lUYUVn89mxEe_YpiOqB9nG_RxSRqyt6DqG8z-c9B6rDWhvEW_
最新宝宝名字,26,0,26,1,27500000,http://www.baidu.com/link?url=Nmm3zRlJHwGzaEIjpPp13UVPcLiw9RqojGprvSfBjEHBo56jjAaWS6qPOKGpFBInG6CeKrjLV8YjS0Sus3ITcK
双胞胎姐妹起名,26,9,17,1,3090000,http://www.baidu.com/link?url=2w4tYnBWdkXzSESHT1BZFojbZhUSnIvpCDtrXs9Aky5g9TOt1RQcl8d7QEK898dEU9NonVnHegGa-J-MA2S1hCb6cKzb8ZzoG1OUhY2kBr6dNEhU0nL5c03iohwaBQz0
熟食店起名,26,9,17,1,173000,http://www.baidu.com/link?url=EOJm9rRsiQ4K8JbEj-RVSt0CSxNH85uewFIueV7zGi032qygMc-8fPW3uJz5gPZoMBEHbM_tTS6uxSQKtP_qQK
男孩子名,26,0,26,1,10500000,http://www.baidu.com/link?url=q3YS2lK6Fi0pq1pFUBTPSKfyMorou350AWRxuTuhaWinle9VjYk8BTznmGw4Lsp41z5zRDs2dQasG2_t3g72xKuzi4oCB8r2-4eY9EUp7Se
张姓女孩名,26,8,18,1,518000,http://www.baidu.com/link?url=t40z9SJ5xekAkYEJnWs5jw1CQwE_0LSlndsJUzud0exv_YIwiisTSTdRznTM2ZoHN-dNb6NfzxmVv4z_zCD9bq
谢姓女孩起名,26,26,0,1,99700,http://www.baidu.com/link?url=RIkH2T3BYOWeXTNVlIEZT5DPpqScTsi-XSbI-CxwUML8Hnf5lKXFrMHpHL1M-dctLOMiw3Mfj7Csf-TCfn2NgTfxm2d9Nqz2NwTTNjc4wAG
取好名字,26,0,26,1,9380000,http://www.baidu.com/link?url=u5dTO8o6tFkLZAjkFPMPpdzekiyEKhjDN4JJnV3aUwVB_uBrLGpilkvxGZyeJ_NSsxAOBZ5sVXXasjt0DJQK-GArNea-8MSDW4ukcSlKwta
宝宝起名测试,26,0,26,1,5420000,www.yw11.com
典故起名,26,9,17,1,3840000,http://www.baidu.com/link?url=h258XJ609NU2EwYfWcrWftMTb7adKf8CNyWXvRcXVvxC1VoZC7DNm2VXLosO8YVOg5Fsm85CvAvfptASk0cBF_
好听的舞团名字,26,9,17,1,657000,http://www.baidu.com/link?url=EQpspogVAuXaP9ZSwb_4uyEdDHK1SxphWkrZZacnMaSpaSvnZFMfoliu4gQO9V4zwYPZsvku8jVeFhhJBckvIOtbfkqo7nTqlIhQtMMQ74e
土特产店名,25,25,0,1,548000,http://www.baidu.com/link?url=3j6uHly3qaDiGJrQdELdB2rAVpYjjVPMrg2zMMjQc_o2QQM4WtdAG8tLcK9mFAhlCfIPh9vMz1MjWgBbugaCJ_
女孩子英语名字,25,17,8,1,22200000,http://www.baidu.com/link?url=rkvPUkhltXMiDYcvsr76UPIuzuRq4mE2LYwENNh5uB8dSg0iyR3GjpUdtGHahcU4WGcGCWZK5OJ0CFmp-hkke9vhA8CBOjQZ7zM7ocBS02O
传奇好听的名字,25,25,0,1,6220000,http://www.baidu.com/link?url=Jo9j1iCE3Dy7nbtEmmSki1MN08wiurWwboAB8AP6qLUevBHTi1q2OtpxxOOaWVrZ_2s1Jnd9640wYm7bZpXZAq
游戏家族名称,25,8,17,1,1540000,http://www.baidu.com/link?url=LEm6ua1hRrihzxqJqMbXZ5QLamudQvs1VOSkSfGWKucsVV2R-kQ78TfvBRbO6V2XZgrIWlSr5CoELl6mqzGkV_
软件公司名称,25,25,0,1,9440000,http://www.baidu.com/link?url=gxnkFkE7bXSLzYN33T6499SvZ6YknAp2D7obyOXi2RQ1DAhK3t_m8j0KlFotpQzBQQGk8e7jLOhIRqa0UctMTK
公司 名字,25,25,0,1,23200000,http://www.baidu.com/link?url=mECK-h-dSHbk6WbxbweNXZlIeIST-s6b9g79tym0lZx6LZqpFD6ICu7TYV0t18x5
传奇家族名字大全,25,25,0,1,2840000,http://www.baidu.com/link?url=wOP-J0K4X65VTh3fSw6OTOU8yMOSa67nGBcX0D3sXAeJ9Vf2xsJycwtx-Il65XL9A4AD3EEkW2hWOBQAR2ErBa
丁姓女孩起名,25,25,0,1,124000,http://www.baidu.com/link?url=Qr7i63ia8D09EYSX4SV-FUSidNGFjuThUcJFwAJGpSB4yseopOPYHNng590vuUo_Tpy-4cbIv2b9vPVm9pcGVNNDnvqNL4TvLCrNY8mLasu
姓杨女孩起名字大全,25,17,8,1,1640000,http://www.baidu.com/link?url=PvQ1YUAvSW68wkLzq7TZvd30o57YViGDwhKElDe5NMCHv6lgQ4P3GOe6PlTlkIMMbRc_MRIcIFRwDMiSXFCHiV8BFsOZmy9ggKqwKteh8mK
按生辰八字起名字,25,17,8,1,7820000,http://www.baidu.com/link?url=A3L1Jq9aY-yZvu7PDvCzkDOkgjZXEsFucARpYsmritsOn3FwO8arEN-d6LGOdAub
经典女孩名字,25,17,8,1,3230000,http://www.baidu.com/link?url=BiwlQX5GAD4-m2YJ9LvoZTlKtb_0Q1GX9FknaZGEPUzUi8ZbtOSPYkxXCz3RVbfeBYA8D-PQANmFLMtllIZuJ_go2fvH2HC0_YqPEqFvmNe
游戏搞笑的名字,25,8,17,1,3880000,http://www.baidu.com/link?url=sT3Uio1IWNbZ6luVeqK0WB7bDvZUTltA448w42F2zZMbB9j-zoitWarL6XIbGY4X7TYRNU4-z3FOjKbEbzirVq
魔兽世界角色名,25,25,0,1,1300000,http://www.baidu.com/link?url=VMTwI6ZdnjW-YR20ndtUKkvw5SAjOrut6SY2Nf6d8q8oM6yZeuGWk5VWHhsXTT6ZjWyRXoEAfC97tJV4MYHuMq
如何给公司取名字,25,25,0,1,32800000,http://www.baidu.com/link?url=ezKvvS2HvKWBLIBtGSEeyBGuSzoPVEuvw_IpZBKAuIVQpGIKUPziFkERXfhrOaIkaWnP2sDESh66YQHc34nDEq
三人组合名字,25,17,8,1,1250000,http://www.baidu.com/link?url=ocyyp8h-YKSWiwGoDB4L1DMi24KTK1SSrYf_fYU9mIbnTm0GVR1bmZNVBdNd_GL5o5E_CbC_xvocJbSWrnon-UnLTcFEwEilCmxgBU5zPD_4D7OibHj2ynX0ioOnxFtZ
路姓起名,25,8,17,1,52100,http://www.baidu.com/link?url=EJbtpKW7NcrMbiN1USZCvi2CUTPNK2ArFy-cLnnqwl79uRa4BAbWxg72z1QE27DRgEDLJcTHfP3SbyIUHOJwDLZUR4YgLvePp46Xwh3bfWa
商城名字大全,25,17,8,1,21300000,http://www.baidu.com/link?url=BIy516O-JvheNNfhsksW-O3KW78JiQhk4YW1ly7gxMNYQYI2cz5Exj5RhAbPdmf7q1goOKQgfNpp9Sxgzxezta
冒险岛游戏名字,25,25,0,1,1250000,http://www.baidu.com/link?url=kzJJRfkNS-5Ux7ieRhcpC0Z6QwgiBDQN_hXhGNooR_dbICg2sxq4j2dHIlSEui-SUIeIIzFAiZXG7iyeF6r97K
免费按生辰八字取名,24,24,0,1,7980000,http://www.baidu.com/link?url=T-ZeHD8ly8uOF4cJAvElrSOFdis-A-hle-i9fysAQ9V7tsPywfOg3rVKMMOM8LXL
游戏帮会名字,24,16,8,1,1910000,http://www.baidu.com/link?url=wnbw46wDMAcJ_loV8wk2B-B39m5wSSrsz-o3dc4tJbsJ3NXO7_yeFrVqhRpWIXF6iA4haCq_SFFAux-8g3z5ja
外国女人的名字,24,24,0,1,17200000,http://www.baidu.com/link?url=qu9tEtq67lw4i4hWy5zwJmmmwMVKieVmzaeBtZt5MywWvfH_v-40x1hDCW_JR4leoMEzHBJLVom3KuiKkw-OlzsGNqDZdgiF9hlNpwgo4ci
霸气家族名,18,0,18,1,6240000,http://www.baidu.com/link?url=UQoesURrEsUM4NvE5ZacHg9l9hOPja47tWrx2zKUI7E559A7ra2_99mcdyqnAAeacWw2sVgcs89aGHDYVrRkmq
奖项设置名称,18,18,0,1,3360000,http://www.baidu.com/link?url=NqPuhVvpXuFE64-VpwN4PVYiixlpYSRufzAnqoPued0-xVeW9NlzA0E6dJFwcDtYWfe8HQlpRINn6XpEyO_mRjpY1pYux5vUC1-IFaEf_BS
张姓取名字大全男孩,17,8,9,1,485000,http://www.baidu.com/link?url=nKxqy53WQTaNOo2JdHbvrcuvfmOk42upfnuwNl6SY0926A3xoQPS37_X-4I_A6rZBYWt1q0HVWlVObLRzqUmQa
个性群昵称,17,0,18,1,2190000,http://www.baidu.com/link?url=l89GkG4MNxTrxWFmVUUeigYPaoZK1NU3L6x6Ir34ltgBRIAWm7o1Ap1beF0KydEkQHa89l1fOW6CLRZPBfL64_
cf战队名字设计,17,9,8,1,1960000,http://www.baidu.com/link?url=wBBDsgK256ESMemnswequBt1MuaaKKSlIn-_O6l7vfzWmRxuVlYerslrllYJ9A0Tr50eVh4Yk4TchKNkcVIeHa
群组名,17,8,9,1,4380000,http://www.baidu.com/link?url=tMiFzOfECiHaN_sILsMyxJov09jao8EpYPCPa5xJBXYx13yao8ZePulSOo59VgCREvBB8LsI-_GJDVLwcDbhRq
魔兽网名,17,17,0,1,3560000,http://www.baidu.com/link?url=rl5BuEhcLciaqOBsGoTLlChbjTJZzxv0k_biVhLhYE_BhHkdci_i5pubz5Ui3s4v0vn1RPdUeoliek44nOm2wK
焦姓起名,17,0,17,1,64100,http://www.baidu.com/link?url=N4uokbp6_tBDxMDt4g3ugucsyH3RQ5A7Mfdp2f5RogV-aY7qQH0kqJE82zADVLQdeq6OONHIxfGjr7bPomH9xq
徐姓名字大全,17,8,9,1,3400000,http://www.baidu.com/link?url=M_24mj7TIDH8DvFh0rkAYgk7Dvsd2TjQNL7mL-BZUulJ6Mvfu_79bS7x-JtFa8S6G91Lru7ZKKaUBHaMwkWBpq
流行的英文名,17,8,9,1,5640000,http://www.baidu.com/link?url=FvO2tgeeKGkJ8YWNFjbYc5ai422TEHQrWuVnJJRpPXjA7wY_S_DJcVhYWywDgNTDMzNsrpLibvpd5BcW79VZ8FWbeMo5y_1D4omxgi3inpe
童装店取名,17,0,17,1,316000,http://www.baidu.com/link?url=8voKf7zbTaao9jf9y2jglTmVh4PBQv_cm63cmh8tMhJKPBPf1Ws7HzEQSdhtet5DlSRa7LhjOLGl8mPSQtj-Mq
备注姓名,17,17,0,1,18900000,http://www.baidu.com/link?url=3TPsYDPrVsZbjGiUn2i-i6UbKJzw-gKyp_CNkrClvI_HI_7tncTfggQx5cIar2HvIVB8YukCp1IK5Xs6cjnXQhuuv_WqasPS4AQ0olRyxua
行会名字大全,17,17,0,1,1120000,http://www.baidu.com/link?url=PYPQpPFyRxTppRye5sNbwDj60o__5m1hUyB8ZlhRAKmPmP5Kp3PyDuzIbLFivfkVsRfrngtBsDbIUgc2nSWWua
国学起名,17,9,8,1,3110000,http://www.baidu.com/link?url=XFUQq0cZMdI0HXLYhmByvy2Z5HDbv6eZSG6d97sIkPh5hmeyvFI8T5zb504f85voCfWDxnG-8K-XINNhkNwlZa
好听的yy频道名字,17,17,0,1,9920000,http://www.baidu.com/link?url=6UjjAkeDHz0EBBb428sPYFc9yjcJj9C4iMx2nTOR3KwGa0zerWETvuYO8PKb649q8RqchIpdUy9N5_lwNVe4vp6I40Q9Q4pQPsqAfW8QDIa
好听的蛋糕店名字,17,0,17,1,447000,http://www.baidu.com/link?url=fNcfp4WAl2NPRNhV0jaL4gMWWDYM1KDvD2MtJyDMygbm-WIkvBJAk9x-bWH_YZW1fwUs4ZMgJd0hhOPeptebB_
英雄联盟的英文名字,17,9,8,1,2620000,http://www.baidu.com/link?url=ZzIPOzebXpgK_L_8DRiJKhiWctVTsM7YewhRUclCEZHROoDrmOxr1IdnHBFcoMP-7ky6fXPpivdQknRwrAlhaq
小孩取名测试,17,8,9,1,5840000,www.yw11.com
英文的游戏名字,17,17,0,1,3780000,http://www.baidu.com/link?url=A_fKqlwEfbERC6qa2M56hpYtrx4IJL8OOUfqt261O1xptBvo8cVNxPMXnLJB7Yaq7WjwzovTWAgo4Q-_ob7BBSBu3kVnWz_SAoOxbOgKmda
婴儿起名打分,17,8,9,1,9460000,www.yw11.com
李姓女孩名,17,0,17,1,463000,http://www.baidu.com/link?url=9wkaNEAGryPeZ7VxJB3gtfcmpCGs3OQuiU9TGBVQp7aTPvM4dXWEOuQ8yL3HM5HtTsSNkA4Nc1EncupzDOwKya
可爱的男生名字,17,9,8,1,43600000,http://www.baidu.com/link?url=OvGtsJ9Z9TORYhXyIJFNxB2X_UUxpLA4mUNQXyHQE4JnghdVJpjeNYOMG9TRPC_7XXOPEFLbNWVbfNt8UNfgMc9092OxJ26pU8v9Aglg-n3
企业起名网免费取名,17,17,0,1,15500000,http://www.baidu.com/link?url=97AI9X4eP9z1e2xef1UoekYVZAhF5rXWT2lxDHrsRdDhCjFNR4RaYd1xsqH0gV7Z
cf战队名称,17,8,9,1,554000,http://www.baidu.com/link?url=uUh5ACbuytvryGPkVq13zapGv5US3Bj0CvVPUxwFG4BR2g-nmRhbk89CMzE3DaFYjKTeqyUZhJzQkFa5bv1RXU4W4y7lUagyaJETVZi_Uve
女装品牌名字,17,17,0,1,3750000,http://www.baidu.com/link?url=27gyCScun1sajHgY4kQ0Y0szPbBYnMAoCmmdoMs44QRxhXeKKvYI0SsT1CMmjlvFp0zAgiQmq2pzg5HN8e02sa
传奇世界名字,17,17,0,1,3170000,http://www.baidu.com/link?url=ZrgYPM5Gm1vdLPTzk4j2dl6XIxZUN5LGSpLt4dyIA9bzl4xQ6eOUjIVRERkR3oGOHxNOGvjiudiaq5G-yMn63aGqQ0oUSEPrZqxvMJaEdu3
刘氏姓名大全,17,0,17,1,295000,http://www.baidu.com/link?url=KZDi5nO4j0kx9sjvl2cPxLd3EtbEzfJugQNEA2-OuuKhe3p6NYrwuABtkq_9PfblcUukWa8RUAlIshXniPxN6q
旅馆名字,17,8,9,1,9540000,http://www.baidu.com/link?url=zKfMujyv2RxSUtuTnbZMsJzDgyAKZGT6CoVnebysOoce6J919b7yAsoCV7z0IZcZiK9UlXZErzsGRVmQzuDeEq
玩具店名,17,8,9,1,2880000,http://www.baidu.com/link?url=4IIGuAd5--eCEpuMn-Z1PxahreXRvnRx2rgR8p_uv5XHLXF9W_ykyXGybNUf7E1wdMikiQ67ZZvOWHM0D-vJ4K
在线取名网,17,0,17,1,2490000,www.yw11.com
最炫的名字,16,16,0,1,1990000,http://www.baidu.com/link?url=UKdZ9mNlI7aCof0PJ_lhhoRRWCNz8f_rVcnvsGbJF6h6546EZPrbiNFYiuG2n0FYLf8f0T4wkApHxeWgMmonhK
马年女宝宝起名,16,16,0,1,2230000,http://www.baidu.com/link?url=BSZpyy_q-817fsvAdj69vmwCafMi6a5pt3XLz615BX9sPGTlv-Y-pXsBKqlQszSCkNU0F2jop5LzXrLPTcvf9q
小拇指短代表什么,16,16,0,1,439000,http://www.baidu.com/link?url=MlhlneKqZmhYLDuzYhkUwKCRpaTr3CvDWviP0M-eMsMiMuWWOtL1J8F9EEJXN6U_e4G93C6udVyS09GUKcR3O12XpQTWvFW3ExwMq2lvlfka8ZN_DWTKjp_sYnpyynOe
免费姓名网,16,16,0,1,2070000,www.yw11.com
炫舞女生名字大全,16,16,0,1,561000,http://www.baidu.com/link?url=Ph7UT9BlXIv1a7f_4y7kAdppjQ79p9FgBml5kcL3ms79aLWBA57Vw2QJPDZh3FEJ185wn65XFR65NAYhB-rpya
好看的游戏英文名字,16,16,0,1,37600000,http://www.baidu.com/link?url=VlLeOVlW4Ny9R8-WxRfcWu4lganRtevaFs0Iw3VyH2Q6AKEskwihlHT5PVAr7zlgYdpd-mo9LbMhV-dOr2ZqMH1WyqnsbG7j-80Aj2qn2lm
男孩名字大全2014,16,16,0,1,8440000,http://www.baidu.com/link?url=_mvP9j6ISR26S-Qf9_nXp11I1lM52946RlJ8rA6IR6om1TLe4rPGenh7X5vtiqC3a2Yn_i7_5YCo8t4z1LMyyjurcltLMNUP8HvvZs9qrSC
赵姓名字大全,16,16,0,1,311000,http://www.baidu.com/link?url=EHvMZzm6C77QxIZky5w_XUQPHImxIXVSNiEHBrvxBo8i6zVFSHw9XxgxZfMW45ugs_XH2mGkI3T1fmyXw2mvE_
周易测名网,16,16,0,1,306000,http://www.baidu.com/link?url=bdGjQxsBkqQtrWQ_2uocNZd88C1CkQT7SLgG5DUTLML_56MrxwDL_i613R8DC5lwmjxi-ksz_HfOYykfabfp_K
dnf个性名字,16,16,0,1,3760000,http://www.baidu.com/link?url=V2WmmPPM9ljh1orT_jkBptVwqbKKHHfCgY3BJGHEAxQMO-V5gPh5T9kEKYo6zdVj3o7PIRljeVU32fTUlzPUO_
免费生辰八字取名字,16,16,0,1,10900000,http://www.baidu.com/link?url=n78-Aav1xgzc3KoHHPvHfC7qJmEF3Vml87W6NV8rYDk_qVF4FleT1MEBrVBGyB9S
魔兽世界的名字,16,16,0,1,4260000,http://www.baidu.com/link?url=vo-NKaDBAI9SfusCzKD6V6608yrNOoxki_GWmNV6Wu8libod56ixcnMNxMK_qYfQWs5_aTSLpCGGQfxNqWB3Ca
好听英语名字,16,16,0,1,5950000,http://www.baidu.com/link?url=MzRpgB6QnJCsaTi-syfeuG4i0Ux5amSymMD-6QIARHTe1Ode2WfVawxIO1fl5SDYxzY55ZiB_Zk91wVuJN7-r6POWmbz8wGcrPZu7GxfhCy
女孩常用名字,16,16,0,1,29900000,http://www.baidu.com/link?url=CfNJ9V2d8zaJLMNZ32YjUc-ddoahKIroAIujSWnAR8Gm2R0WSig8ZOp9HlEBH76huKfvNUSIr5naWBjSQi1ksbLlBrfuPtjBh0r_NkNrKSu
李渊登位,16,16,0,1,25900,http://www.baidu.com/link?url=Q-1uzJqm6FBRIgMQQr-NRQCmrpTch6N2fKCpJkOTcLp45XIJG3jFCukX8bilscEzbZ7Vfd84jR0veeCqNxKTE9waPTmx0rnq75WXKBNXs-O
传奇sf名字,16,16,0,1,1140000,http://www.baidu.com/link?url=NYqpE4xC2Imi5KBGE9e5aC-xMf-Doo7rnDuYPRn1s2Ri5ONsfZ_whP_oB-wP1BORlGYefKJ8cMROpSLBJsxHp_
热血传奇名字,16,16,0,1,5370000,http://www.baidu.com/link?url=B8RFg4lraMXO3WUHzpDhIJkO_bhG5gAEKIcIg8kmfNofjAqrCnwoodTC7NyTq68urwjLIM-rYvxH9Owl60mm5q
最有意义的名字,16,8,8,1,5480000,http://www.baidu.com/link?url=hYGao-8Zb1l6y-nhI1QdRcKQNnAYZBU3pj75V7eNTTD2EbLrNOHTOoNZZ4WHJ3YvSXdCs8sf6aMOmTFCqOde4jY0FIchk_BW8RTVSnvnbVO
顾姓起名,16,16,0,1,132000,http://www.baidu.com/link?url=elbLxwsQrZLrDxjhqSPrjAKB25YVXJtE5A2dqfhT929PbkzBaE922yL_rI5Z_ux_74YEHuUwZiyphg3eSEexoq
宝宝取名测分,16,16,0,1,29000000,www.yw11.com
街头篮球好看的名字,16,16,0,1,1600000,http://www.baidu.com/link?url=QTEXoPwmKKXmyplL_vH4iPX2XrRIKucAXtuoyT0-NF6OUDY84SkgqnKE0SuRjguAKMW1Jhzl55qFNzbxhkmm7a
好听的企业名字,16,16,0,1,31000000,http://www.baidu.com/link?url=CwPmCKqKTqHNhYti4_SiOnsw7fv44sees0SNDLO63ofdWf_OLsLb49Djg6mf5WsV4uYUBYq0Zd6hhz6UPObC2a
起名的网站,16,16,0,1,6740000,www.yw11.com
化妆品取名,16,16,0,1,2580000,http://www.baidu.com/link?url=nZ0GSJq6zlhk9pKp2oQHAoEwdaS_uCxyTNKy_kIicn5uehvYuV611PuivD5Lj_iP_F1gnfTEdrk3eaeMablpMa
女姓名大全,16,16,0,1,29900000,http://www.baidu.com/link?url=hXUK_8OLg0EmXf33XjJGTZX8oM3yL3ZX8bFGH17T8zR09NupmZaKLCjgbnxhSA4U5xVne-9BpfebL_6WfY_B4QYsZqOQrD-wxx3ylDc2Hwi
女婴儿名字,10,0,10,1,18100000,http://www.baidu.com/link?url=dsjtv3ZVVv_QMtBJEfpTVxQVtorHvXbx8cCdAEvyAl3lYgcQGnqqCVtVh2txXhhlEYty2DT4XnQ-THyNg_R32a
梦幻诛仙网名,10,0,10,1,270000,http://www.baidu.com/link?url=Yfhhh_3GQi7zujMu9B1IuwTaQJVRVnFbS-JPQ3wps08N9hjIZ3bo2Yn2VHPggO4VZAVPMAreh6Wr1rytLvZjZUUNfVd_iYPo-2gfZN4x9Bm
取女孩名,9,0,9,1,4960000,http://www.baidu.com/link?url=eW7RGRgXUGdMx9CQOHSoTBbIVU-XEFgR-i5uoLDG8gAZAc9prZC2l47Aei9c-Qsk7LkSMhobtnBB8x8b6juPntFLCmrrsfPhUfmQefkrSPK
男孩子英语名字,9,0,9,1,16900000,http://www.baidu.com/link?url=fJwwu5kyiA5Wp8vilMNOKWiLPrGsSXAwxZ4el60pVxmgaOifmOI5u8Pgb-GtX3zYJzAHto7cb4FrKAkbYrLD2TkYeaFMQyJqP8Z-9IRX5uq
女孩子好听名字,9,0,9,1,14200000,http://www.baidu.com/link?url=joFnPSvueEDPX1TDdSg0rd31svcmEAbuPIagaq1wPNqBcGUcHzx4UfXRrUXczOaCQWmgaA-aIjikINaAr17cwVB2grkX86vMdxCT9HQDHg3
美发店起名,9,0,9,1,692000,http://www.baidu.com/link?url=DJLDl6k3KG1obogah9n2Kcvfr9chm1IGM1SxdhKccCsNXcxFBFtpXtrEi3njzokpasqs7BLnacC5YhmsXjph2K
qq群好听的名字,9,0,9,1,10100000,http://www.baidu.com/link?url=cxffIXeDmSJPempC3T6MoSIehbQ9GOHdUglJZXKLuBZbOU0k23beFJ8r3m-2RL1-fkoVLyEh6uiWdIXQJQ6770l2an-2_mgvtQuwGC7FRUW
魔兽世界起名字,9,9,0,1,3680000,http://www.baidu.com/link?url=ebvE6In70Txy7MfgLewX8FUSdTWrUa0ZKNuEyQQ2j7MevIxqKKYPju_uYqU4viCwSAXWd9BZSIRQ16E8KxtbEa
qq空间相册名,9,0,9,1,33700000,http://www.baidu.com/link?url=dPGsQrX70yXY2F-6LWcEEtFSndCCBPWR7xB50w9QieNEaGCK8cX4CZRAcxHGP7LnveKpGotI84wb0ioyOiw2X62Vrf9dha18_tazT-Vj7fa
李姓取名字大全男孩,9,9,0,1,660000,http://www.baidu.com/link?url=TahehVZ0CsCGHyahNn6gp0tUfaRDSOjbOrhq5MIoW7EKbLWz-ns7Oss0ZFfb55eSCAtOk2OXLbEqS7dgxmUytq
起名网免费打分,9,0,9,1,2790000,www.yw11.com
好听的班群名字,9,0,9,1,153000,http://www.baidu.com/link?url=g_P_dhIlahYq1vBLuHTvGKqkbgd45U0hZiUuIsRxpJ5unxCL7gMpYcFeMwr82NQrRkNTuQ4clmnjk6M8_FS1Llzp7rgTN0-Gysk5NH_V51W
古玩店名,9,0,9,1,986000,http://www.baidu.com/link?url=gp-4iqVfvOItC8VKr4Wjjn3V9EgV60Tz4l711Tn9sjoV-nYZHl8XwlbmG856mlDPOu5jqhtQLLAKIhSMj7Zm8a
服装店英文名大全,9,9,0,1,676000,http://www.baidu.com/link?url=Md3XBwHtcziWhPu5q_oaH3zg3Gs6sOWtqxDKtVYLzQwiiN1seIbJxS3WSHZmSIUwTEZY-0099uQusqsYFKW7T_
中国取名,9,9,0,1,5570000,www.yw11.com
段姓女孩起名,9,0,9,1,336000,http://www.baidu.com/link?url=SSHd3Z47GgmSjiMTag_znZXy6HDgAVXqlEx94YAuE7GdXNJdiVlU8rsQiuGR4EaiSUAWXLovAQvAcH77z0sVmAmQbhLySvN7iytH7wY2RR7
街头篮球个性名字,9,9,0,1,1130000,http://www.baidu.com/link?url=T60rJ4_tURzdtuD-63eeqB6zN6NMRKLNM-9-bqIED3LE9_rqduO56GSgCM4aOQYtR8-2W3b-UbHmAP7NsGdtg_
酒楼起名,8,8,0,1,2160000,http://www.baidu.com/link?url=aO-R5jnveuRZ_Uu8lnIIwdedS5CPrwZfVdY4BBpg_RuT5R2K2lK5XwBhxNCe0jzxLgT1lB08KfYnSMyzfWY9Va
cs名字大全,8,8,0,1,666000,http://www.baidu.com/link?url=919USRBCfc4qmUHuf3HZ-YMqSDBQGUetLXW2KqRgNFeiHa6wTvqSpq6fVX9muBkfmdIsmugCAgxC8ydYmnu1I_
名字 大全,8,8,0,1,20900000,http://www.baidu.com/link?url=3bud4yXzPnjV-Tq35zcnGCC3Z14X9-3WVZLZMVvDPMcEOO2PU9REXDzOtXB4MOEb
郑姓男孩起名,8,0,8,1,262000,http://www.baidu.com/link?url=F50EBqRTIgucVVSyKAXnZ0f8PBVfa8x0ZVxMies7jp09Nlm6op8u9v2sNsDTk33t9c0ZvfJZ-ftHb06BIR62va
免费起网名,8,0,8,1,3800000,http://www.baidu.com/link?url=GXtezGF2onrGyAgaRiQarXGacGsz8H4Q5VM_MRT98En8MwHINDqYC6_t6FNP20mt
个性群名字,8,0,8,1,6630000,http://www.baidu.com/link?url=mhMx_W4kSIqeHdckh0dvr2zRDvyye0pc5hxeR6x4O9Z_TbCWHa9FdCpd4xxLR4Q-eV9h8mIHlVRwwueHu-gzwa
店名预测,8,8,0,1,2270000,http://www.baidu.com/link?url=9m-D-jWXpBTLaIGBQq_D9CnNZz4wR4e4bSSLuB6mW84jjhJiqsBWdtEVpfG_PdVMITWxxYYt-hpnlg1ugHNkjK
专业取名网站,8,0,8,1,8090000,www.yw11.com
quming,8,8,0,1,39600000,www.yw11.com
好听的结拜名字,8,8,0,1,768000,http://www.baidu.com/link?url=jNQg78cpxJef2fM8Ts575Nny_saJtpE5dUeM2ceLx0eXiae-XvtvL1Xe_UkdjxXFaj5ydIVnlh4FpAEW0fP__-qGRL_tkFnftl-Xxzvt3pC
好听的魔兽名字,8,8,0,1,5730000,http://www.baidu.com/link?url=D5rNRCuc2rv2CHn1ckC5aNLRBGOTO2Hil41RSdaQT6wHodbidWIcBRfpbO4GWigV0liMWOLIYc7xngHDp-Y7UlDSLFiqxmMxiu5DDtCsxY7
好听的军团名字,8,8,0,1,4430000,http://www.baidu.com/link?url=4HgndHyoKEymZyDfUIi0yjldFz-cm7PWfwpXEva2etTEdzxo1ZYv_f8VidtQv_qx4en8dZ1s_QqwMxXpIsu8d_
yy网名大全,8,8,0,1,4300000,http://www.baidu.com/link?url=1_6BXkMOg92MsAKZCBLEdMrUgzqKRRqtzp1WzKxttQRsY-1Hvr4pWws-RDXSV7M8c8RUMUwja_ximoiqI1w2cNS8HgBduhffI746cSX3BgC
汽车取名,8,8,0,1,3670000,http://www.baidu.com/link?url=PGaeu75eonpzICpfxaQh726jKbNy83ovIhGEWlHShjFzH9JtLGkhVPOShlrWsgGoYkeLuzs-feBJSCSFX19Lc_
女性网游名字,8,8,0,1,17000000,http://www.baidu.com/link?url=bjmmMolzQzMCZpsxqvGPdOOjJaQSCXBiGnn-rAHVI1ixEAXYrow-hOq8plfi28smjnCF_BAx4il47xe1FhdJ6a
免费公司起名测名,8,8,0,1,2580000,http://www.baidu.com/link?url=B0_1EKtUMAZXsXmDjthpuDBjXGjOUk0bGJ80db__DqjvYD15z9J2uSLyvCK2L_7n
网络游戏帮会名字,8,0,8,1,5070000,http://www.baidu.com/link?url=Gg8EDV4Qk8RYtoUWyGhNR_yhRRbiRga7tM1Xw2QUd38gin60vgnZQLfa77VgSy_SwDXWHLNwvNJI4E98IEeh5_
街头篮球游戏名字,8,8,0,1,1240000,http://www.baidu.com/link?url=I_PxEwitBdtD4PBHAO21Bqu2l5DJ9_xgkJcJXjcl_H8sTg7FET0yEjKwrX8V4b2O2xOlS2VOjqUMA6HSc8E8eq
牛宝宝起名,8,8,0,1,2710000,http://www.baidu.com/link?url=B5YJY-g1E45RS5d1_6XGoG2Cuzxz-anyLCpC7PTenu-o8d8CyzZnubdiVVfwiM7g0TjVMZiJm9i1ox9ORih9qa
陈姓女孩名字大全,8,8,0,1,216000,http://www.baidu.com/link?url=HaGT0SIV_dpXUjBl9VjLPQezqEHXpC_O4PlcwOHf0B3Ozze2-bVi48ZstxD-AMUTAF1dfX2CwCvW2H3u2RXwra
贸易公司取名大全,8,8,0,1,181000,http://www.baidu.com/link?url=WeCq6XUtkd9_HOaAU35PuJqSuVegw4mHpZYL56QsQEMiZb2QD62O-KNFDwHsKkPoxJxYmW89JpegqMApEvjwlq
女孩名字大全2014,8,8,0,1,7120000,http://www.baidu.com/link?url=6mbGCmtn9W6vLQndZFqPcz8rL2R9fUv6K_RkPfsquEY7xTboi7jC9ysDvnFccNRj54i2w9ivgfWNbDdtY00lBuiNyxvU7YZcQBCCgtj_Suq
在线生辰八字取名,8,8,0,1,9820000,www.yw11.com
宠物用品店名,8,0,8,1,264000,http://www.baidu.com/link?url=8r1i4JagldwA5oamIwBBSeniKCNh1F1Z7fiFMWc2XGLeqs7XJEBcdchuUqEXL-mrtTpoW0qFj9QCdJ-_IuiNfK
如何取好听的名字,8,8,0,1,27700000,http://www.baidu.com/link?url=UnWT6nR1bHUgPkkN__O8QuG54IBEeB4EtNW-jd5DfK0k2MiSJ3cyFhHxFT81mp8_
旅店名字,8,8,0,1,5530000,http://www.baidu.com/link?url=ixCax1ffg3mMb8coea48akChbaoNtPkn6_P3lDqCZz1t-Y38xdH44GcAITXI-J64SGF2OzlJCYJEX9leQ3lz9K
头衔名,8,0,8,1,342000,http://www.baidu.com/link?url=AA1_Rc8dWTZnKPlRmmhBdzNCm8lhOROqSywUSUpe_3F5zGZ7rYAzHKvEmVK1wpxiYMh5wBARQu6h2AbrxbL20woWQMWDUtDFdnzI0yqy9QS
宝宝免费起名打分,8,0,8,1,20300000,www.yw11.com
电脑取名打分,8,8,0,1,2140000,http://www.baidu.com/link?url=JuJI2Brm95wusGr8iGJdLnFBJ1aqHbxO01VIXoMbtLaV4qUPQwQZZjDolblbBOGDJqrsXfQoDoGYSv3F6DV19_
饮料起名,8,8,0,1,2480000,http://www.baidu.com/link?url=QaaPTdykM-vJ_d3J6ZJugMC5XP0Ml1nc7Y5rdV0WLiy-TRR5_JvJjNDgqC51ve6mIEZ2LCkCWJiiTGS4bju4Ua
微博英文名字大全,8,8,0,1,12100000,http://www.baidu.com/link?url=64OWPzlOMUqmf_Nk7X4soGQT2w2OXzUd5OBLebF1ifJ8EVPwEWXy9gqw1FygXjGs21khkjxx4vHt3lPOuIeIbnjaGIg-ZFhX51xXU59zOHO
好听的男人名字,8,0,8,1,38200000,http://www.baidu.com/link?url=xcRhqg2RgLhIk2CD0Tzo0H68AUl6FmQFbUoOsNsnUJGBy2yZYBPyq-DVOud7AZzEHpjCNMq-vqk225Ke570p73KtWZ9kZ8ZHmQcyC2KELwa
孙姓男孩名字大全,8,0,8,1,217000,http://www.baidu.com/link?url=Pe5tM1Wm0v1oo__5ktbTI1PlyinjKPVBbMp8RtkzJ2NuO1HumdusEtrM724rrrilp201viO1K0XVr7QEwMPTgK
起女孩名,8,0,8,1,5500000,http://www.baidu.com/link?url=TFIedsv0urMCazcopig2K8O8a-Oz4vXyMZO12NjEEvl0kGxzCnB9wh3xYtvUoZ_MmwrZKNYEEsZzvuSqpN9vf2F-o4Ium4GzCzyYPeHrAva
好听的传奇名字,8,8,0,1,6190000,http://www.baidu.com/link?url=pz_l60iVkG8g1coesxGWQOBaG3_Bmtek5cou7OmwzDhokc4jRFRBVCaEptodPkpe-iwG1BP2apz7GGCxpb82D_
问道个性名字,8,8,0,1,26200,http://www.baidu.com/link?url=zfP9uz8hHkM7vOlZBqu_mLE6bR46bh6TAV-Or-jWSeDD5w0anLdLOzj-VIIyGHZoC6DZWjR9xxZoecm2hDK03q
好听群名字,8,0,8,1,10800000,http://www.baidu.com/link?url=ibTK3_EP47eC9m0Qn1Z1O2iBN3y6q59aQmc8FLE1F43e_EBG4n6pQ22l4ovGOZANvojSngZ2rdBPckjzWoxdnJ5434ugDpZMD7oVJvcCORe
魔兽世界个性网名,8,8,0,1,425000,http://www.baidu.com/link?url=6SJbUywwsSY3YTEfoXvaeFaY7G_4kOOoZhcnCqz3zL9MVvDiXjfC6ke5Tc9jLxN9A2t12cc7onb7ydnXeSS5Fq
免费取姓名,8,8,0,1,12200000,http://www.baidu.com/link?url=6f2LKa6thk9Pp151ZhaeE51-3l_BtAkDVm-sdNrIJEDDqFjUKmu4fKJgMLfZHiSt
魔兽世界好听名字,8,8,0,1,1240000,http://www.baidu.com/link?url=2mNWtDyWt-UN7nyt3gama-17e8hBhRbNY_V8iFz5TAmiOy9OcMbU2awJ7xd_cO8gdTFLxnXLXT-cOS7o1JBGZQwV-VPn8LJXdL6zHCxN88e
刘姓女孩名字大全,8,0,8,1,760000,http://www.baidu.com/link?url=OD1yEwWN2ANbU6o9c4QRWMn8kSU-Xq61DQWSgn8x6cZqJG-roxFT07ycXBdcRzUIStsJCe-hftIf-86kedIL-K
英语名字女生,8,0,8,1,5930000,http://www.baidu.com/link?url=Cz7M5LLr526DZoDskmSi--v3Iv7bviRlCsJ3Bg10PD2sZLt-2-MyG5gPsoyy2QPFwCFYPaJUC1OIKV6IirzVCoWDusZT7Di3r6juf6vr33_
传奇好名字,8,8,0,1,5000000,http://www.baidu.com/link?url=-85_e0CKl5c0wol0KqqGt85cGZUGiqkmnsq0XxtfhjBbSchha0nU8VitflNY-NsbEoJDe7pYEzLoD7IZbDFVa_
中国周易起名网,8,8,0,1,4260000,http://www.baidu.com/link?url=9Ne1h84pNLSofq3EOhZ3DQT2WLWrja_yl9d-Vk3xjO2CfhKnZgxdZVplM1IRoXbq
好听的乐队名字,8,8,0,1,14800000,http://www.baidu.com/link?url=luUz_r9QsfGY9OdaGtHgqqD-d1u9WcNoDh343ts2BnxCjOo7oqheIltl6BJbNdLiqgeFH4icggW5sZyvngQQKAUpD6pfFpPU9zz7RiKQSNg5Ko2THJnaPGomXPeEJeon
在线取名软件,8,8,0,1,3110000,www.yw11.com
在线起名字软件,8,8,0,1,223000,www.yw11.com
传奇昵称,8,8,0,1,6960000,http://www.baidu.com/link?url=FP8IHqzeKkhjf-M7Z_WOdhNJrtRSKF8LIvc8GMJuzNYxxNJInwGY-r3zL7XoIhCRuGisOE4C_3B9sT5ynWgd8K
游戏个性家族名字,8,8,0,1,5720000,http://www.baidu.com/link?url=x5IH1w2cPTjuZQiArr3JjaR716Xp4bP5faTBbJE9gF8z5X3sxJMM0iCVEEwh__oXZx5pnn_mDRQvqcC5c9EpSK
好听的家族名称,8,8,0,1,1390000,http://www.baidu.com/link?url=IHA27X74ZCTfmgJa5a9G_Hmh9T_CGOw-kqM3lWeZZOAqYcRu4q1t3cuz-yLhPBmS5Y3u7dG5T0sPBygO0gVu2a
传奇游戏人物名字,8,8,0,1,6050000,http://www.baidu.com/link?url=OWYAgoQUU8ltw3WuxgjWfhEqHLmEaGFg7g59MH7BmFxXLvhjSwUuxmcHc26Wf70peVOGRHpG0qxUCwF5MZkrvK
取名系统,8,8,0,1,3780000,http://www.baidu.com/link?url=KCxpSu7F0vJ2knNvTKzt--d3Y7Zh-zumu8qStI2yvlh3UaDM3e38QwyUTAuNlRYL
起好名,8,8,0,1,15500000,http://www.baidu.com/link?url=al24FUkFh6iFYDl8BzlRiH3hcLSl9fnuM6sotmvy_9wf0skVj1cLmPrOv2IvaUWP
最拽的游戏名字,8,8,0,1,113000,http://www.baidu.com/link?url=Fro73b1OsIs1oQIhkVUmQVOn6iYfqC5uPx-LBxvBe7E4kDmPPjGQwB7zFwI7q69OCwquuUgfOf0hSpTb6E-US_
宝宝取名宝典,8,8,0,1,5230000,http://www.baidu.com/link?url=wsOMy6JoEG2a_7gbroggNpcPq2LoL6l7aC4f9KpDwxvGDzE8oHSgMXq1iOZPcniegi3sTXSI2lknXnNO-CYyIK
姓刘名字大全,8,8,0,1,2480000,http://www.baidu.com/link?url=WnHVyVJ2HjUrzsNdtEivbZGE342tUIwwiJf1PGC1pZudU8u5qc0IcoeVcWU44yTaxx71JL4SLdrlrveo7Vzfr_
魔兽好听的名字,8,8,0,1,1770000,http://www.baidu.com/link?url=YzJUNQRE8iTmnot8YlQtg9xijjZYLPOIbajjXPh1oJ36Y7jHMU87RzEJu9OW0VvYl_g6CiWqmsJPvk3CamI-MpNOZlcWSzHq6pneoRAwvA3
兔宝宝起名,8,0,8,1,7820000,www.yw11.com
中国宝宝取名,8,8,0,1,4070000,www.yw11.com
魔兽角色名,8,8,0,1,2420000,http://www.baidu.com/link?url=3RvOfagX2Dm7jXTs5-hVKDCfLpKOSa9dx_LSqnJsyTJxLCE-p2Fw80Y3ZPOfoq8y7v6RtTmfOKLOeIwAabKG5q
cf好听的英文名字,8,8,0,1,15900000,http://www.baidu.com/link?url=tZ_D23Iivsj0agt6ckFcH0uklEOkrnfON0QXm5-enkrwQlAhwq_nBdF0VWyy0LDbOVRne4Fv0Gq7Vi0Qrp2xtk0W4kbdz27mDF4PNhOg9Um
